bangumiTitle	aliasJp	aliasSearch
漫研部	あいまいみー	漫研部,漫研社,あいまいみー
漫研部~妄想突变~	あいまいみー～妄想カタストロフ～	漫研部,漫研社,あいまいみー,あいまいみー 妄想カタストロフ
幕末摇滚	幕末Rock	幕末摇滚,幕末ロック
网球并不可笑嘛 第一季	てーきゅう	女高网球部,てーきゅう,网球并不可笑嘛 第一季
网球并不可笑嘛 第二季	てーきゅう 2期	てーきゅう 第2期,网球并不可笑嘛
网球并不可笑嘛 第三季	てーきゅう 3期	女高网球部,てーきゅう 3期,网球并不可笑嘛
STRANGE+ 第一季	ストレンジ・プラス	ストレンジ・プラス
STRANGE+ 第二季	真 ストレンジ・プラス	真ストレンジ・プラス (第2期),STRANGE+ 第二季
FRANCESCA	フランチェスカ	法兰雀丝卡,フランチェスカ
人生	人生相談テレビアニメーション「人生」	人生,人生咨询电视动画,人生相談テレビアニメーション
斩·赤红之瞳！	アカメが斬る!	斩·赤红之瞳！,アカメが斬る!
DRAMAtical Murder	DRAMAtical Murder	DMMD,DRAMATICALMURDER,戏剧性谋杀,ドラマダ
青春之旅	アオハライド	青春之旅,アオハライド,闪烁的青春
荷包蛋的蛋黄什么时候戳破才好？	目玉焼きの黄身 いつつぶす?	荷包蛋的蛋黄什么时候戳破才好？,目玉焼きの黄身 いつつぶす？,何时捣碎煎蛋黄？
每度！浦安铁筋家族	毎度!浦安鉄筋家族	浦安铁筋家族,毎度!浦安鉄筋家族,元气！抓狂一族
KERORO军曹 前作		ケロロ军曹,青蛙军曹
迷你偶像	ぷちます! -プチ・アイドルマスター-	小小偶像大师,迷你偶像大师,迷你偶像
复仇者联盟		复仇者,AVENGERS
犬神同学和猫山同学	犬神さんと猫山さん	犬神さんと猫山さん,犬神同学和猫山同学
剑灵	ブレイドアンドソウル	BLADE & SOUL
我们大家的河合庄	僕らはみんな河合荘	仆らはみんな河合荘,BrainsBase
忍者神龟 第一季		TMNT
忍者神龟 第二季		TMNT
宝石宠物 第二季		宝石宠物 TWINKLE☆,宝石宠物 SUNSHINE,宝石宠物 KIRA☆DECO！,宝石宠物 HAPPINES
宝石宠物 第三季		宝石宠物 TWINKLE☆,宝石宠物 SUNSHINE,宝石宠物 KIRA☆DECO！,宝石宠物 HAPPINES
魔法科高校的劣等生	魔法科高校の劣等生	魔法科高校的劣等生,魔劣
游☆戏☆王 GX 	遊☆戯☆王 デュエルモンスターズGX	游戏王,YU-GI-OH!,遊戯王,游☆戏☆王,游戏王 GX,遊☆戯☆王 デュエルモンスターズ GX,打牌王
游☆戏☆王 ZEXAL	遊☆戯☆王 ZEXAL	游戏王,YU-GI-OH!,遊戯王,游☆戏☆王,游戏王 ZEXAL,遊☆戯☆王ゼアル,打牌王
罗德岛战记 本篇		ロードス島戦記,罗德斯岛战记
罗德岛战记 -英雄骑士传-		ロードス島戦記-英雄騎士伝-,英雄骑士传
罗德岛战记 享用罗德岛战记		ロードス島戦記,罗德斯岛战记
金色琴弦～primo passo～	金色のコルダ〜primo passo〜	金色のコルダ
金色琴弦～Secondo Passo～	金色のコルダ〜secondo passo〜	金色のコルダ
众神的恶作剧	神々の悪戯	神々の悪戯,诸神的恶作剧,BrainsBase
一周的朋友。	一週間フレンズ。	一週間フレンズ。,一周的朋友,BrainsBase
魔法少女大战	魔法少女大戦	魔法少女大戦
棺姬嘉依卡	棺姫のチャイカ	棺姬柴卡,棺姬彩卡
棺姬嘉依卡 AVENGING BATTLE	棺姫のチャイカ AVENGING BATTLE	棺姫のチャイカ AVENGING BATTLE
风云维新大将军	風雲維新ダイ☆ショーグン	风云维新ダイ☆ショーグン,风云维新大将军
爱丝卡与罗吉的工作室 黄昏之空的炼金术士	エスカ&ロジーのアトリエ〜黄昏の空の錬金術士〜	爱丝卡与罗吉的工作室,黄昏之空的炼金术士,艾斯卡与罗吉的炼金工房
请问您今天要来点兔子吗？	ご注文はうさぎですか？	请问您今天要来点兔子吗？,ご注文はうさぎですか？,点兔
乒乓		
龙娘七七七埋藏的宝藏	龍ヶ嬢七々々の埋蔵金	龙娘七七七埋藏的宝藏,龍ヶ嬢七々々の埋蔵金
目隐都市的演绎者	メカクシティアクターズ	目隐都市的演绎者,メカクシティアクターズ,阳炎Project,阳炎计划
M3~黑色之钢~	M3〜ソノ黒キ鋼〜	M3～索诺黑钢～
头文字D First Stage	頭文字D	INITIAL D,头文字D
头文字D Second Stage	頭文字D Second Stage	 头文字D,SECOND STAGE
头文字D Third Stage	頭文字D Third Stage	INITIAL D,头文字D
头文字D Fifth Stage	頭文字D Fifth Stage	头文字D,Initial D
头文字D Final Stage	頭文字D Final Stage	头文字D,FINAL STAGE
绝灭危愚少女	絶滅危愚少女 Amazing Twins	絶滅危愚少女,绝灭危愚少女
DOUBLE CIRCLE		ダブルサークル
机器人少女Z		魔神少女Z,ロボットガールズＺ,ROBOT GIRLS Z
妄想学生会	生徒会役員共	妄想学生会,黄段子学生会,SYD,生徒会役員共
未来卡 搭档对战		フューチャーカード バディファイト,FUTURE CARD BUDDYFIGHT
信长之枪	ノブナガン	ノブナガン,信长之枪
超级索尼子	そにアニ -SUPER SONICO THE ANIMATION-	超级索尼子,すーぱーそに子,SUPER SONICO,索尼子
献给某飞行员的恋歌	とある飛空士への恋歌	献给某飞行员的恋歌,とある飛空士への恋歌
兔宝的悲惨日常	うーさーのその日暮らし	兔宝的悲惨日常,T宝的悲惨日常,うーさーのその日暮らし
兔宝的悲惨日常 觉醒篇	うーさーのその日暮らし 覚醒編	兔宝的悲惨日常,T宝的悲惨日常,うーさーのその日暮らし
姐姐来了	お姉ちゃんが来た	お姉ちゃんが来た
银之匙 Silver Spoon 第一季	銀の匙 Silver Spoon	SILVER SPOON,银之匙,银の匙,銀の匙 SILVER SPOON
银之匙 Silver Spoon 第二季	銀の匙 Silver Spoon 第2期	SILVER SPOON,银之匙,银の匙,銀の匙 SILVER SPOON
GO!GO!575	Go! Go! 575	PROJECT 575
未确认进行式	未確認で進行形	未確認で進行形
PUPA	pupa	ピューパ
农林	のうりん	农林,のうりん
世界征服 谋略之星	世界征服～謀略のズヴィズダー～	世界征服 谋略之星,世界征服～謀略のズヴィズダー～
稻荷恋之歌	いなり、こんこん、恋いろは。	稻荷恋之歌,いなり、こんこん、恋いろは。,狐仙的恋爱入门
甘城光辉游乐园	甘城ブリリアントパーク	甘城光辉游乐园,甘城ブリリアントパーク,甘城BRILLIANT PARK
电器街的漫画店	デンキ街の本屋さん	デンキ街の本屋さん,电器街的漫画店,电器街上的书店
记录的地平线	ログ・ホライズン	记录的地平线,ログ・ホライズン
记录的地平线 第二季	ログ・ホライズン 第2シリーズ	记录的地平线,ログ・ホライズン,记录的地平线 第二季
魔弹之王与战姬	魔弾の王と戦姫	魔弹之王与战姬,魔弾の王と戦姫
天体的秩序	天体のメソッド	天体的方式,天体的秩序,天体のメソッド
银仙	繰繰れ! コックリさん	银仙,缲缲れ! コックリさん
临时女友		女朋友临时,GFB,GIRLFRIEND BETA,GF(仮),女朋友(仮),ガールフレンド(仮)
我家浴缸的二三事	オレん家のフロ事情	我家浴室的二三事,我家浴室的现况,オレん家のフロ事情
日常系的异能战斗	異能バトルは日常系のなかで	日常系的异能战斗,異能バトルは日常系のなかで
咬屁股虫 第一季		おしりかじり虫,咬屁屁虫
咬屁股虫 第二季		おしりかじり虫 第2シリーズ
TRINITY SEVEN 七人魔法使	トリニティセブン 7人の魔書使い	七人魔法使,トリニティセブン,魔道书7使者
世嘉硬件女孩	Hi☆sCoool! セハガール	HI☆SCOOOL! セハガール
大图书馆的牧羊人	大図書館の羊飼い	大图书馆的牧羊人,大図書館の羊飼い
我，要成为双马尾。	俺、ツインテールになります。	我要成为双马尾,俺、ツインテールになります。
绿林女儿罗妮娅	山賊の娘ローニャ	山賊の娘ローニャ,山贼女儿罗尼雅,山贼的女儿罗尼亚
RWBY		RWBY系列,Ruby Weiss Blake Yang
RWBY 第二季	RWBY Volume 2	RWBY系列,Ruby Weiss Blake Yang
夏恋战机	夏恋戦機	KAREN SENKI,夏恋战机
成为偶像www		成为英雄WWW
HYBIRD CHILD	Hybrid Child	Hybrid Child
HENTAI！	へんたい！	变态！,へんたい！
纳米核心		NANOCORE
功夫兔与菜包狗		KUNG FU BUNNY,功夫兔和菜包狗
猫和老鼠 2014版	The Tom and Jerry Show	TOM AND JERRY,汤姆和杰瑞,TOM & JERRY
猫和老鼠 旧版		TOM AND JERRY,汤姆和杰瑞,TOM & JERRY
中国惊奇先生		
不可能恋爱		可不能恋爱,好传动画,不可能恋爱？
潜行吧！奈亚子 Remember My Love	這いよる! ニャルアニ リメンバー・マイ・ラブ（クラフト先生）	這いよる! ニャルアニ！,潜行吧！奈亚子 Remember My Love
变态王子与不笑猫	変態王子と笑わない猫。	変态王子と笑わない猫,不笑猫,变猫,变态王子
我的朋友很少	僕は友達が少ない	我的朋友很少,僕は友達が少ない,邻人部
我的朋友很少NEXT	僕は友達が少ないNEXT	我的朋友很少,僕は友達が少ない,我的朋友很少NEXT
琴浦小姐	琴浦さん	琴浦さん,琴浦小姐
斩服少女	キルラキル	KILL LA KILL,双斩少女
某科学的超电磁炮	とある科学の超電磁砲	科学超电磁炮,某科学的超电磁炮,とある科学の超電磁砲
某科学的超电磁炮 OVA	OVA とある科学の超電磁砲	科学超电磁炮,某科学的超电磁炮,とある科学の超電磁砲
某科学的超电磁炮S	とある科学の超電磁砲S	科学超电磁炮,某科学的超电磁炮,とある科学の超電磁砲
问题儿童都来自异世界？	問題児たちが異世界から来るそうですよ?	问题儿童都来自异世界,问题儿童
锁锁美同学@提不起劲	ささみさん@がんばらない	ささみさん@がんばらない,锁锁美同学@提不起劲
黄金拼图	きんいろモザイク	きんいろモザイク,黄金拼图,黄金拼图 第一季
魔王勇者	まおゆう魔王勇者	新魔王勇者,向着丘之彼方,「成为我的东西吧勇者」「我拒绝！」,魔王勇者女魔法师外传
翠星之加尔刚蒂亚	翠星のガルガンティア	翠星のガルガンティア,翠星之加尔刚蒂亚,翠星的GARGANTIA
恋爱研究所	恋愛ラボ	恋爱ラボ,LOVE LAB,恋爱LAB
京骚戏画 WEB版2	京騒戯画 第二弾	
京骚戏画 2013版	京騒戯画	京骚戏画,京騒戯画
声优战队VOICESTORM7		
金色时光	虹色デイズ	金色时光,虹色デイズ
天方魔谭MAGI	マギ The labyrinth of magic	マギ,魔奇少年,地上最强阿拉丁魔奇,MAGI,天方魔谭MAGI
天方魔谭MAGI 第二季	マギ The kingdom of magic	マギ,魔奇少年,地上最强阿拉丁魔奇,MAGI,天方魔谭MAGI
夜樱四重奏 1	夜桜四重奏 〜ヨザクラカルテット〜	夜樱四重奏,荆棘之路
夜樱四重奏 花之歌	夜桜四重奏 〜ハナノウタ〜	夜樱四重奏花之歌,荆棘之路
夜樱四重奏 星之海	夜桜四重奏 〜ホシノウミ〜	夜樱四重奏
伽利略少女	ガリレイドンナ	伽利略少女,ガリレイドンナ
武士弗拉明戈	サムライフラメンコ	
DIABOLIK LOVERS	DIABOLIK LOVERS	魔鬼恋人,DIABOLIK LOVERS
少女骑士物语	ワルキューレロマンツェ	ワルキューレロマンツェ,WALKURE ROMANZE
苍蓝钢铁的琶音	蒼き鋼のアルペジオ -アルス・ノヴァ-	苍き钢のアルペジオ,苍蓝钢铁战舰,苍き钢のアルペジオ ーアルス・ノヴァー
核爆默示录	COPPELION	COPPELION
想成为世界最强	世界でいちばん強くなりたい!	想成为世界最强,我想成为世界最强,世界でいちばん强くなりたい！
PHI·BRAIN 神之谜题 第一季	ファイ・ブレイン ～神のパズル	PHI BRAIN,神之谜,神之谜题
PHI·BRAIN 神之谜题  第二季	ファイ・ブレイン 〜神のパズル 第2シリーズ	PHI BRAIN,神之谜,神之谜题2,神之谜题
PHI·BRAIN 神之谜题 第三季	ファイ・ブレイン 〜神のパズル 第3シリーズ	PHI BRAIN,神之谜,神之谜题2,神之谜题
限制级杀手	殺し屋さん	限制级杀手,殺し屋さん
第一神拳	はじめの一歩	
第一神拳 New Challenger	はじめの一歩 New Challenger	第一神拳,New Challenger
第一神拳 Rising	はじめの一歩 Rising	第一神拳,Rising
KY系JC小空气	KY系JCクウキちゃん	KY系JCクウキちゃん,KY系JC小空气
有顶天家族	有頂天家族	有頂天家族
玉响～hitotose～	たまゆら〜hitotose〜	玉响,たまゆらじお
玉响～more aggressive～	たまゆら〜もあぐれっしぶ〜	玉响,たまゆら
跟班×服务	サーバント×サービス	SERVANT X SERVICE,サーバント×サービス
现视研1	げんしけん	现代视觉文化研究会,げんしけん,现视研
现视研2		现代视觉文化研究会,げんしけん
现视研 二代目	げんしけん 二代目	げんしけん二代目,现视研
科学小飞侠Crowds	ガッチャマン クラウズ	科学忍者队,科学小飞侠CROWDS,科学忍者队CROWDS,GATCHAMANCROWDS
科学小飞侠 OVA	ガッチャマン	科学忍者队,科学小飞侠CROWDS,科学忍者队CROWDS,GATCHAMANCROWDS
蔷薇少女 第一季		ROZEN MAIDEN,ローゼンメイデン
蔷薇少女 梦之终结	ローゼンメイデン・トロイメント	ROZEN MAIDEN,ローゼンメイデン
蔷薇少女 序曲	ローゼンメイデン・オーベルテューレ	ROZEN MAIDEN,ローゼンメイデン
新蔷薇少女	ローゼンメイデン	ローゼンメイデン 新作
战姬绝唱SYMPHOGEAR	戦姫絶唱シンフォギア	戦姫絶唱シンフォギア,戦姫絶唱,战姬绝唱
战姬绝唱SYMPHOGEAR G	戦姫絶唱シンフォギアG	战姬绝唱
八犬传-东方八犬异闻- 第一季	八犬伝 -東方八犬異聞-	八犬伝,八犬傳─東方八犬異聞─,东方八犬异闻
八犬传-东方八犬异闻-  第二季	八犬伝 -東方八犬異聞-  二期	八犬伝東方八犬異聞(第2期),八犬传
超次元游戏 海王星	超次元ゲイム ネプテューヌ THE ANIMATION	超次元游戏,超次元游戏 海王星,超次元战记 战机少女,超次元ゲイム ネプテューヌ
特例措置团体斯特拉女子学院高等科C3部	ステラ女学院高等科C3部	斯特拉女子学院高等科C3部
RDG 濒危物种少女	RDG レッドデータガール	RDG　レッドデータガール
恶魔阿萨谢尔在召唤你 第一季	よんでますよ、アザゼルさん。	
恶魔阿萨谢尔在召唤你 第二季	よんでますよ、アザゼルさん。Z	よんでますよ、アザゼルさん。Z
人鱼又上钩	波打際のむろみさん	波打際のむろみさん
恶之华	惡の華	恶の华,恶之华
KARNEVAL狂欢节	カーニヴァル	狂欢节,カーニヴァル,KARNEVAL
写真女友	フォトカノ	フォトカノ,PHOTO KANO,恋曲写真,照片女友
王者天下	キングダム	キングダム,王者天下 II,王者天下,Kingdom
王者天下 第二季	キングダム 第2シリーズ	キングダム,王者天下 II
学活！ 第二季	ガッ活! 第2シリーズ	ガッ活！（第2シリーズ）
穿透幻影的太阳	幻影ヲ駆ケル太陽	透过幻影的太阳,幻境之光,幻影ヲ駆ケル太陽,驱影之阳
我是国王		我是国王大人,ぼくは王さま
麻雀酒店	スパロウズホテル	スパロウズホテル,麻雀酒店
天使的水果糖	天使のどろっぷ	天使的水果糖
成年女性的动画时间 第一季		女性的动画时间,大人女子のアニメタイム,大妹子的动画时间
成年女性的动画时间 第二季		女性的动画时间,大人女子のアニメタイム,大妹子的动画时间
歌牌情缘	ちはやふる	花牌情缘,歌牌情缘,ちはやふる
歌牌情缘2	ちはやふる2	歌牌情缘,花牌情缘,ちはやふる2
南家三姐妹	みなみけ	みなみけ,MINAMI KE
南家三姐妹 再来一碗	みなみけ〜おかわり〜	みなみけ,MINAMI KE
南家三姐妹 欢迎回来	みなみけ おかえり	みなみけ,MINAMI KE
南家三姐妹 第四季		みなみけ ただいま
Q弟侦探因幡	キューティクル探偵因幡	キューティクル探偵因幡,Q弟偵探因幡
学生会的一己之见	生徒会の一存 碧陽学園生徒会議事録	学生会的一己之见,学生会的一存,碧阳学园学生会议事录,生徒会の一存,碧陽学園生徒会議事録
学生会的一己之见 Lv.2	生徒会の一存 Lv.2	学生会的一己之见,学生会的一存,生徒会の一存 Lv.2
GJ部	GJ部	GJ部中等部
失忆症	AMNESIA	アムネシア,健忘症,AMNESIA,精靈情緣,(AMNESIA),失忆症,BrainsBase
闪乱神乐	閃乱カグラ	閃亂神樂
直白标题机器人动画		直球表题ロボットアニメ,直白标题,直白標題機器人動畫
AKB0048 第一季	AKB0048	
AKB0048 第二季	AKB0048 next stage	
我的妹妹是大阪大妈	僕の妹は「大阪おかん」	我的妹妹是大阪大妈
漫画少女	まんがーる!	まんがーる！,漫画少女
石田和朝仓	石田とあさくら	石田与朝仓,石田とあさくら
初音岛	D.C. 〜ダ・カーポ〜	D.C,D.C.～ダ・カーポ～,初音岛
初音岛 第二季	D.C.S.S. 〜ダ・カーポ セカンドシーズン〜	D.C,D.C.～ダ・カーポ～,初音岛第二季
初音岛II	D.C.II 〜ダ・カーポII〜	D.C,D.C.～ダ・カーポ～,初音岛II
初音岛III	D.C.III ～ダ・カーポIII～	D.C.III～ダ・カーポIII～,初音岛III
十万个冷笑话 第一季		
十万个冷笑话 第二季		
尸兄		我叫白小飞
山海师		
神魄		ZINBA
馒头日记		
撸时代		
死灵编码		
少年泰坦出击		
复仇者集结		
鸭子的生活	ぢべたぐらし あひるの生活	ぢべたぐらし あひるの生活,鸭子生活
高中也疯狂		
宫河家的空腹	宮河家の空腹	宫河家的空腹,宮河家の空腹
笨蛋的悲剧人生	バカ・ミゼラブル	笨蛋的悲剧人生,脱力
小公主苏菲亚 第一季		
小公主苏菲亚 第二季		
独眼巨人少女斋枫	サイクロプス少女さいぷ〜	独眼巨人少女斋枫,サイクロプス少女さいぷ〜
平成警察		へ〜せいポリスメン!!
地狱幼稚园		
K	K	K,K 第一季,K 动画
加速世界	アクセル・ワールド	アクセル・ワールド
樱花庄的宠物女孩	さくら荘のペットな彼女	樱花庄园的宠物女孩,さくら荘のペットな彼女,樱花庄的宠物女友
邻座的怪同学	となりの怪物くん	邻座,brainsbase
创圣的大天使	創聖のアクエリオン	AQUARIONEVOL;EVOL
创圣的大天使EVOL	アクエリオンEVOL	创圣的大天使EVOL
这个是僵尸吗？	これはゾンビですか?	这货是僵尸吗,这个是僵尸吗？ ,これはゾンビですか?,魔装少女就是本少爷
这个是僵尸吗？OF THE DEAD	これはゾンビですか? オブ・ザ・デッド	这货是僵尸吗,这个是僵尸吗？ OF THE DEAD,これはゾンビですか? ,魔装少女就是本少爷
人类衰退之后	人類は衰退しました	人类衰退之后,人類は衰退しました
爱杀宝贝 国语版	キルミーベイベー	KILL ME BABY,BABY PLEASE KILL ME
爱杀宝贝 日语版	キルミーベイベー	KILL ME BABY,BABY PLEASE KILL ME
散华礼弥	さんかれあ	散华礼弥,さんかれあ,僵尸哪有那么萌？
恋爱随意链接	ココロコネクト	恋爱随意链接,ココロコネクト,心连情结,心与心的连结
要听爸爸的话！	パパのいうことを聞きなさい！	パパのいうことを聞きなさい!,听爸爸的话
迷之彼女X	謎の彼女X	谜样女友X,迷之女友,谜之女友,谜之女友X,迷之女友X
就算是哥哥有爱就没问题了对吧	お兄ちゃんだけど愛さえあれば関係ないよねっ	兄爱,我与亲爱哥哥的日常
三人行必有我妹	この中に1人、妹がいる!	三人行必有我妹,この中に1人、妹がいる!,NAKAIMO,其中一个是妹妹
猫物语（黑）	猫物語（黒）	猫物语,猫物语 黑,猫物語 黒
食梦者	バクマン。	バクマン,BAKUMAN,爆漫王
食梦者。2	バクマン。2	バクマン,BAKUMAN
食梦者。3	バクマン。3	バクマン,BAKUMAN,食梦者
向阳素描 第一季		炎阳素描,ひだまりスゲッチ
向阳素描 第二季		ひだまりスケッチ×365
向阳素描 第三季		炎阳素描,ひだまりスゲッチ
向阳素描 第四季		ひだまりスケッチ×ハニカム
只要你说你爱我	好きっていいなよ。	好きっていいなよ,只要你说你爱我
CØDE:BREAKER 法外制裁者	CØDE:BREAKER	CODE:BREAKER,法外制裁者
武装神姬 Moon Angel	武装神姫 MOON ANGEL	武装神姫 MOON ANGEL,武装神姬MK2
武装神姬	武装神姫	武装神姫 MOON ANGEL,武装神姬MK2
绯色的欠片 第一季	緋色の欠片	緋色の欠片,绯色的碎片
绯色的欠片 第二季	緋色の欠片 第二章	緋色の欠片,绯色的碎片
超速变形GYRO ZETTER		超速変形ジャイロゼッター
兽旋战斗MONSUNO		
激战！弹珠人 第一季		クロスファイト ビーダマン
激战！弹珠人 第二季		クロスファイト ビーダマン
TARI TARI		TARITARI
女子落	じょしらく	女子落,少女落语家,じょしらく
恋爱与选举与巧克力	恋と選挙とチョコレート	恋と选挙とチョコレート,KOICHOCO,恋爱选举巧克力
夏雪密会	夏雪ランデブー	夏雪ランデブー,夏雪密会
薄樱鬼	薄桜鬼	薄樱鬼,薄桜鬼
薄樱鬼 第二季		
薄樱鬼 黎明录	薄桜鬼 黎明録	薄樱鬼 黎明录,薄桜鬼 黎明録
薄樱鬼 雪华录	薄桜鬼 雪華録	薄桜鬼 雪華録,薄樱鬼 雪华录
薄樱鬼 番外		
魔力家族	アルカナ・ファミリア -La storia della Arcana Famiglia-	魔力家族,Arcana Famiglia,アルカナ・ファミリア,圣灵家族
公立海老栖川高校天闷部	えびてん 公立海老栖川高校天悶部	公立海老栖川高中天文社,虾掰天文社,えびてん,公立海老栖川高校天悶部
希望宅邸3D 第一季		ゆるめいつ 3でぃ,希望宅邸
希望宅邸3D  第二季		ゆるめいつ3でぃPLUS
Fate/Zero 第二季	Fate/Zero	FateZero,FATE ZERO,FZ,F/Z
坂道上的阿波罗	坂道のアポロン	坂道のアポロン,坂道上的阿波罗
钓球	つり球	つり球,钓球
一起一起这里那里		あっちこっち
黄昏少女×失忆	黄昏乙女×アムネジア	黄昏乙女×アムネジア,黄昏少女×失忆
夏色奇迹	夏色キセキ	夏色キセキ,夏色奇迹
鲁邦三世 -名为峰不二子的女人-	LUPIN the Third ～峰不二子という女～	鲁邦三世,鲁邦三世～名为峰不二子的女人～,LUPIN the Third ～峰不二子という女～,鲁邦三世 名为峰不二子的女人,峰不二子という女
银河KICK OFF！！	銀河へキックオフ！！	銀河へキックオフ!!,银河KICK OFF！！,向银河开球
交响诗篇 第一季	交響詩篇エウレカセブン	交響詩篇エウレカセブン,エウレカセブンAO
交响诗篇 AO	エウレカセブンAO	交響詩篇エウレカセブン,エウレカセブンAO,交响诗篇
ZETMAN 超魔人	ZETMAN	超魔人,ZETMAN
枪械少女	うぽって!!	UPPOTE,うぽって
战国Collection 		战国大乱斗,戦国コレクション,brainsbase
翡翠森林狼与羊		暴风雨之夜
光明之心 ～幸福的面包～	シャイニング・ハーツ ～幸せのパン～	面包之心,幸福的面包,光明之心,シャイニング・ハーツ ～幸せ
柴犬子	しばいぬ子さん	柴犬子
圣斗士星矢 THE LOST CANVAS 冥王神话	聖闘士星矢 THE LOST CANVAS 冥王神話	圣斗士,冥王神话,聖闘士星矢,THE LOST CANVAS,ザロストキャンバス,圣斗士星矢 冥王神话
小恐龙阿贡		小恐龙阿冈,GON -ゴン-,龙吼GON
金属对决 战斗陀螺 ZERO G		
MINUSCULE ～小昆虫的故事～		
妖狐×仆SS	妖狐×僕SS	妖狐x仆
在盛夏等待	あの夏で待ってる	あの夏で待ってる,相约彼夏,在那个夏天等待
圣诞之吻SS	アマガミSS	アマガミ,圣诞之吻SS,圣诞之吻SS＋PLUS,甜蜜吻痕
圣诞之吻SS+ plus	アマガミSS+ plus	アマガミ,圣诞之吻SS,圣诞之吻SS＋PLUS,甜蜜吻痕
暴力宇宙海贼	モーレツ宇宙海賊	暴力宇宙海贼,モーレツ宇宙海賊,迷你裙宇宙海贼
零之使魔	ゼロの使い魔	ゼロの使い魔,零之使魔
零之使魔 双月骑士	ゼロの使い魔 双月の騎士,	零之使魔 双月的骑士,ゼロの使い魔 双月の騎士
零之使魔 三美姬的轮舞	ゼロの使い魔 ～三美姫の輪舞～	零之使魔 三美姬的轮舞,ゼロの使い魔 ～三美姫の輪舞～
零之使魔F	ゼロの使い魔F	ゼロの使い魔,ゼロの使い魔F,零之使魔F
BRAVE10 真田十勇士	BRAVE10	BRAVE10,ブレイブテン,真田十勇士
罗马浴场	テルマエ・ロマエ	罗马浴场,テルマエ・ロマエ
足球骑士	エリアの騎士	足球骑士
极乐院女子高寮物语	ゴクジョッ。～極楽院女子高寮物語～	極樂院女子高寮物语,极乐院女子高寮物语
武装中学生	武装中学生 バスケットアーミー	バスケットアーミー,武装中学生
OZUMA		オズマ
我们仍未知道那天所看见的花的名字。	あの日見た花の名前を僕達はまだ知らない。	那朵花,未闻花名,我们仍未知道那天所看见的花的名字
命运石之门	Steins;Gate	命运石之门,シュタインズ・ゲート,Steins Gate,石头门
笨蛋，测验，召唤兽	バカとテストと召喚獣	バカとテストと召唤獣,笨蛋测试召唤兽
笨蛋，测验，召唤兽2	バカとテストと召喚獣にっ!	バカとテストと召唤獣,笨蛋测试召唤兽
日常	日常	
花开伊吕波	花咲くいろは	花开物语,花咲くいろは
电波女与青春男	電波女と青春男	電波女と青春男,电波女&青春男
迷茫管家与懦弱的我	まよチキ！	まよチキ!～迷える执事とチキンな俺と～
回转企鹅罐	輪るピングドラム	回转企鹅罐,生存战略,回转QQ罐,輪るピングドラム,企鹅罐,brain'sbase
GOSICK	GOSICK -ゴシック-	GOSICK,哥特侦探,ゴシック
好想告诉你 第一季	君に届け	
好想告诉你 第二季	君に届け 2ND SEASON	
青之驱魔师	青の祓魔師	青の祓魔师,蓝色除魔师,AO NO EXORCIST,青之驱魔师
丹特丽安的书架	ダンタリアンの書架	丹特丽安的书架,ダンタリアンの書架
[C]THE MONEY OF SOUL AND POSSIBILITY CONTROL	C	[C],C,未来钱式,CONTROL,「C」, シー
便·当	ベン・トー	便当,ベン・トー
食梦者玛利	夢喰いメリー	梦喰いメリー,食梦者玛莉,玛丽连梦露
迷糊餐厅 WORKING!!	WORKING!!	WORKING!!,无聊西餐厅,迷糊餐厅
迷糊餐厅 WORKING’!!	WORKING’!!	WORKING!!,无聊西餐厅,WORKING'!!,迷糊餐厅
纯白交响曲	ましろ色シンフォニー -The color of lovers-	ましろ色シンフォニー，纯白交响曲
UN-GO 	UN-GO	因果,UN-GO 
UN-GO 日记短片		因果
UN-GO episode: 0 因果论	UN-GO episode:0 因果論	因果,UN-GO 剧场版,UN-GO episode: 0 因果论
世界第一初恋 第一季	世界一初恋	世界一初恋,世界第一的初恋,せかいいちばんはつこい
世界第一初恋 第二季	世界一初恋2	世界一初恋,世界第一的初恋,せかいいちばんはつこい
世界第一初恋〜横泽隆史的场合〜	世界一初恋〜横澤隆史の場合〜	世界一初恋,世界第一的初恋,せかいいちばんはつこい
请认真和我恋爱！！	真剣で私に恋しなさい！！	请认真和我恋爱,真剣で私に恋しなさい,真剑恋
最终流放-银翼的飞梦-	ラストエグザイル-銀翼のファム-	LAST EXILE,ラストエグザイル-银翼のファム
全职猎人	HUNTER×HUNTER	猎人,HUNTERXHUNTER,ハンター×ハンター,全职猎人
无口的森田小姐 第二季		森田さんは无口
魔法小恶魔！		魔法小恶魔
战国☆天堂 -极-		戦国☆パラダイス-極-
白兔糖	うさぎドロップ	うさぎドロップ
白兔糖 特典	うさぎドロップ	うさぎドロップ
神的记事本	神様のメモ帳	神様のメモ帐,神的記事本
神样DOLLS	神様ドォルズ	神様ドォルズ,brainsbase
滑头鬼之孙	ぬらりひょんの孫	滑头鬼,滑头鬼之孙,ぬらりひょんの孫
滑头鬼之孙～千年魔京～	ぬらりひょんの孫～千年魔京～	滑头鬼,滑头鬼之孙～千年魔京～
SACRED SEVEN	セイクリッドセブン	七合圣石战记,SACRED7,SACRED SEVEN
曾几何时天魔的黑兔	いつか天魔の黒ウサギ	曾几何时天魔的黑兔,いつか天魔の黒ウサギ,天魔黑兔
猫神八百万	猫神やおよろず	猫神やおよろず,猫神八百万
R-15	R-15	R-15 ようこそ天才学園へ!
快盗天使TWIN ANGEL		快盗天使ツインエンジェル,快盗天使,快盗天使双胞胎
吸血猫		にゃんぱいあ
DOUBLE-J		だぶるじぇい,JJ萌艺社,传统艺继承部
刀锋战士		BLADE,ブレイド
怪物猎人日记 岌岌可危猫猫村 第一季		
怪物猎人日记 岌岌可危猫猫村 第二季		
A CHANNEL	Aチャンネル	ACHANNEL,A频道,Aチャンネル
A频道+smile	Aチャンネル+smile	ACHANNEL,A频道
赌博默示录	逆境無頼カイジ Ultimate Survivor	赌博默示录,赌博破戒录,赌博堕天录,逆境无赖开司
赌博默示录 破戒录篇	逆境無頼カイジ 破戒録篇	赌博默示录,赌博破戒录,赌博堕天录,逆境无赖开司
架向星空之桥	星空へ架かる橋	星空へ架かる桥
玛莉亚†狂热	まりあ†ほりっく	玛利亚狂热
玛莉亚†狂热 第二季		玛利亚狂热
我们没有翅膀	俺たちに翼はない	俺たちに翼はない
露蒂的玩具	アスタロッテのおもちゃ！	露蒂的玩具,アスタロッテのおもちゃ！
47都道府犬		
战国鬼才传	へうげもの	へうげもの,战国鬼才传
+TIC模型姐妹		+TIC姐姐,模型姐妹
迷糊软网社	そふてにっ	迷糊软网部,迷糊软网社,そふてにっ
和殿下一起 第一季		和主公在一起,和主公搅基
和殿下一起 第二季		和主公在一起,和主公搅基
真的有呀！灵媒先生		ほんとにあった！霊媒先生
30岁的保健体育		
DORORON炎魔君 熊熊燃烧		炎魔君
哈姆太郎 第四季		
X战警	X-MEN	エックスメン,X-MEN
苏希的动物园		
腹黑妹妹控兄记	お兄ちゃんのことなんかぜんぜん好きじゃないんだからねっ!!	お兄ちゃんのことなんかぜんぜん好きじゃないんだからねっ!!
LEVEL E		レベルE,灵异E接触
超元气三姐妹	みつどもえ	みつどもえ,超元气三姐妹
超元气三姐妹 增量中！	みつどもえ 増量中!	みつどもえ,超元气三姐妹 增量中！
放浪男孩	放浪息子	放浪男孩,放浪息子
恶魔奶爸	べるぜバブ	魔王的父亲,恶魔奶爸,べるぜバブ
FRACTALE	フラクタル	フラクタル,FRACTALE,碎之星
STARRY☆SKY	Starry☆Sky	星座彼氏,Starry☆Sky
RIO RAINBOW GATE!	Rio Rainbow Gate!	里欧彩虹之门,Rio Rainbow Gate!
金刚狼		
麻衣的魔法和家庭日		
万能蔬菜卜卜侠		
Angel Beats!	Angel Beats!	エンジェルビーツ AB ,エンジェルビーツ,ANGEL BEATS,天使心跳,ANGEL BEATS！
魔法禁书目录 第一季	とある魔術の禁書目録	某魔法禁书目录,某魔法的禁书目录,新约魔法禁书目录,新约 某魔法的禁书目录
魔法禁书目录 第二季	とある魔術の禁書目録II	某魔法禁书目录,某魔法的禁书目录,新约魔法禁书目录,新约 某魔法的禁书目录
魔法禁书目录 剧场版	とある魔術の禁書目録 エンデュミオンの奇蹟	某魔法禁书目录,某魔法的禁书目录,新约魔法禁书目录,新约 某魔法的禁书目录
会长是女仆大人！	会長はメイド様!	学生会长是女仆,会长是女仆大人
天降之物	そらのおとしもの	天降之物,天空遗落之物,そらのおとしもの
天降之物f	そらのおとしものf	天降之物,天空遗落之物,そらのおとしもの
天降之物Final 我永远的鸟笼	そらのおとしものFinal 永遠の私の鳥籠	天降之物,天空遗落之物,そらのおとしもの,そらのおとしものFinal 永遠の私の鳥籠
吊带袜天使	Panty &amp; Stocking with Garterbelt	PANTY & STOCKING,婊子天使
荒川爆笑团	荒川アンダー ザ ブリッジ	荒川桥下,荒川,荒川爆笑团
荒川爆笑团2	荒川アンダー ザ ブリッジ×ブリッジ	荒川アンダー ザ ブリッジ×ブリッジ,荒川爆笑团
MM一族	えむえむっ！	えむえむっ!,MM!
大神与七位伙伴	オオカミさんと七人の仲間たち	
花丸幼稚园	はなまる幼稚園	花丸幼儿园,はなまる幼稚園
刀语	刀語	刀语,刀語
传说中勇者的传说	伝説の勇者の伝説	传说中勇者的传说,传勇传,伝说の勇者の伝说
尸鬼	屍鬼	尸鬼,屍鬼,SHIKI
迷途猫OVERRUN！		迷途猫,迷い猫オーバーラン!,Mayoi Neko Overrun!,娇蛮猫娘大横行
守护猫娘绯鞠	おまもりひまり	おまもりひまり,守护猫娘绯鞠
女仆咖啡厅	それでも町は廻っている	妹抖咖啡厅,それでも町は廻っている
STAR DRIVER 闪亮的塔科特	STAR DRIVER 輝きのタクト	闪亮的塔科特,闪亮的拓人,輝きのタクト,STAR DRIVER,驭星者,银河美少年
海月姬	海月姫	海月姬,くらげひめ,brainsbase
FORTUNE ARTERIAL -赤之约定-	FORTUNE ARTERIAL -赤い約束-	赤色约定,FORTUNE ARTERIAL,赤之约束,赤之约定,赤色的约定,命运脉动
梦色蛋糕师	夢色パティシエール	梦色蛋糕师,夢色パティシエール
超级机器人大战OG -DIVINE WARS- 第一季		超级机器人大战OG -THE INSPECTOR-,BrainsBase
超级机器人大战OG -DIVINE WARS- 第二季		超级机器人大战OG -THE INSPECTOR-,BrainsBase
咎狗之血	咎狗の血	咎狗の血
钢铁侠		アイアンマン
农业少女		農業ムスメ！
一期一会~你的话语~		
面包咪咪		食パンミミー
强袭魔女1	ストライクウィッチーズ	强袭魔女,ストライクウィッチーズ
强袭魔女2	ストライクウィッチーズ2	强袭魔女,ストライクウィッチーズ
王牌投手 振臂高挥	おおきく振りかぶって	振臂高挥,王牌投手振臂高挥,王牌投手
王牌投手 振臂高挥～夏日大会篇～	おおきく振りかぶって～夏の大会編～	振臂高挥,王牌投手振臂高挥,王牌投手
二舍六房的七人	RAINBOW 二舎六房の七人	二舍六房的七人,少年犯之七人,二舎六房の七人
逆转监督	GIANT KILLING	GIANT KILLING,ジャイアントキリング,逆转监督
无法逃离的背叛	裏切りは僕の名前を知っている	背叛知道我的名字,裏切りは仆の名前を知っている
恋姬†无双	恋姫†無双	恋姫無双
真・恋姬†无双	真・恋姫†無双	
真・恋姬†无双～少女大乱～	真・恋姫†無双～乙女大乱～	恋姬无双,少女大乱
HEROMAN		ヒーローマン
棒球大联盟 第一季		MAJOR
棒球大联盟 第二季		メジャー 第2シリーズ
棒球大联盟 第三季		MAJOR
棒球大联盟 第四季		MAJOR
棒球大联盟 第五季		MAJOR
棒球大联盟 第六季		MAJOR
最强武将传 三国演义		
极上！！超人气委员长		
变身！公主偶像		
交响情人梦	のだめカンタービレ	のだめカンタービレ,交响情人梦
交响情人梦 巴黎篇	のだめカンタービレ 巴里編	のだめカンタービレ,交响情人梦巴黎篇
交响情人梦Finale	のだめカンタービレ フィナーレ	のだめカンタービレ,交响情人梦Finale,交响情人梦 完结篇
由土里酱		ゆとりちゃん
青春CUP	ちゅーぶら!!	ちゅーぶら!!,青春CUP
怪盗丽奈	怪盗レーニャ	怪盗レーニャ,怪盗丽娅
一骑当千	一騎当千	一騎当千,一骑当千
凉宫春日的忧郁 2006版	涼宮ハルヒの憂鬱	凉宫ハルヒの忧郁,すずみやハルヒのゆううつ
凉宫春日的忧郁 2009版	涼宮ハルヒの憂鬱	凉宫ハルヒの忧郁,すずみやハルヒのゆううつ
乃木坂春香的秘密	乃木坂春香の秘密	乃木坂春香の秘密
乃木坂春香的秘密 purezza♪	乃木坂春香の秘密 ぴゅあれっつぁ♪	乃木坂春香の秘密
DARKER THAN BLACK -黑之契约者-	DARKER THAN BLACK -黒の契約者-	黑之契约者,DARKER THAN BLACK
DARKER THAN BLACK -流星的双子-	DARKER THAN BLACK -流星の双子-	黑之契约者,DARKER THAN BLACK,流星的双子
DARKER THAN BLACK -黑之契约者- 外传	DARKER THAN BLACK -黒の契約者- 外伝	黑之契约者,DARKER THAN BLACK
狼与香辛料	狼と香辛料	狼辛,狼と香辛料
狼与香辛料 第二季	狼と香辛料II	狼与香辛料,狼辛,狼と香辛料,brainsbase
潘朵拉之心	Pandora Hearts	潘多拉之心,PANDORA HEARTS
肯普法	けんぷファー	肯普法,けんぷファー,KAMPFER
白色相簿	WHITE ALBUM	WHITE ALBUM,WHITE  ALBUM
东京地震8.0	東京マグニチュード8.0	东京マグニチュード8.0,东京地震8.0
猫愿三角恋	にゃんこい!	猫恋,猫愿三角恋,にゃんこい!
公主恋人！	プリンセスラバー!	
钢之炼金术师	鋼の錬金術師	钢之炼金术师,鋼の錬金術師,钢炼,钢炼03
钢之炼金术师 FULLMETAL ALCHEMIST	鋼の錬金術師 FULLMETAL ALCHEMIST	钢之炼金术师,鋼の錬金術師,Fullmetal Alchemist,钢炼,钢炼FA
钢之炼金术师 剧场版	鋼の錬金術師	Fullmetal Alchemist,鋼の錬金術師
加奈日记	かなめも	かなめも,加奈日记
钢壳都市雷吉欧斯	鋼殻のレギオス	钢壳のレギオス,钢壳之REGIOS
明日的与一	明日のよいち！	明日的与一,明日のよいち！
圣母在上	マリア様がみてる	圣母在上,マリア様がみてる,玛莉亚的凝望
空罐少女	アキカン！	アキカン!,brainsbase,空罐少女
毒蛇信条		
龙之塔 第一季		迷宫塔,德鲁亚加之塔
龙之塔 第二季		迷宫塔,德鲁亚加之塔
黑神	黒神 The Animation	黑神,黒神 The Animation
铁腕女刑警		铁腕巴蒂,铁腕巴迪
RIDEBACK		背骑少女
脆莓公园 第一季	Brickleberry (Season 1)	Brickleberry (Season 1)
脆莓公园 第三季	Brickleberry (Season 3)	Brickleberry 第三季,脆莓公园 第三季
自杀专卖店		THE SUICIDE SHOP
阿修罗	アシュラ	ASURA,阿修罗,アシュラ
生化危机：诅咒		BIOHAZARD: DAMNATION
秀逗魔导士 第一部		SLAYERS,魔剑美神,スレイヤーズ
秀逗魔导士 第二部		スレイヤーズNEXT
秀逗魔导士 第三部		SLAYERS TRY
秀逗魔导士 第四部		SLAYERS,魔剑美神,スレイヤーズ
秀逗魔导士 第五部		SLAYERS,魔剑美神,スレイヤーズ
仰望天空的少女之瞳映射的世界		MUNTO
源氏物语千年纪 Genji	源氏物語千年紀 Genji	源氏物语,源氏物语千年纪,源氏物語千年紀 Genji
科拉蒂每日的笑话		
胡子小鸡		
阿拉德战记	アラド戦記 〜スラップアップパーティー〜	SLAP-UP PARTY,阿拉德战记
BASQUASH!		
魔神Z 本篇		
魔神Z 真魔神 冲击！Z篇		
战场上的女武神	戦場のヴァルキュリア	战场女武神,VC,戦场のヴァルキュリア,SENJOU NO VALKYRIA
神曲奏界POLYPHONICA 第一季	神曲奏界ポリフォニカ	神曲奏界,神曲奏界ポリフォニカ
神曲奏界Polyphonica crimson S	神曲奏界ポリフォニカ クリムゾンS	神曲奏界,神曲奏界ポリフォニカ クリムゾンS
游魂 -Kiss on my Deity-	タユタマ -Kiss on my Deity-	KISS ON MY DEITY,游魂
豹头王传说		
幸运四叶草		四叶游戏
天国少女	花咲ける青少年	天国少女,花咲ける青少年
你好安妮		
夏之岚	夏のあらし!	夏日风暴！,夏之岚,夏のあらし!
夏之岚！ ～春夏冬中～	夏のあらし! ～春夏冬中～	夏日风暴！,夏のあらし! ,第二季
07-GHOST	07-GHOST	07-GHOST,神幻拍档,七鬼神
苍天航路		
天堂餐馆	リストランテ・パラディーゾ	天堂餐馆,リストランテ・パラディーゾ
初恋限定。	初恋限定。	初恋限定,ハツコイリミテッド
川之光		
海物语	うみものがたり～あなたがいてくれたコト～	海物语,うみものがたり
青之花	青い花	青之花,青い花
NEEDLESS	NEEDLESS	NEEDLESS,死刑判决
大正野球娘		大正棒球娘
GA 艺术科美术设计班	GA 芸術科アートデザインクラス	
战斗司书	戦う司書 The Book of Bantorra	战斗司书,戦う司書,The Book of Bantorra
天体战士 第一季		天体戦士サンレッド,天体战士桑雷德
天体战士 第二季		天体戦士サンレッド,天体战士桑雷德
圣剑锻造师	聖剣の刀鍛冶	
喵丸侦探基鲁敏		
小鸠	こばと。	小鸠,こばと。
轻声密语	ささめきこと	轻声密语,ささめきこと
青涩文学		
空中秋千	空中ブランコ	空中ブランコ
魔力女管家 第一季		まほろまてぃっく
冬季恋歌		
轻音少女 小剧场		轻音,けいおん！,K-ON！,K-ON
CLANNAD	CLANNAD -クラナド-	
CLANNAD ～AFTER STORY～	CLANNAD ～AFTER STORY～	
CLANNAD 剧场版	劇場版 CLANNAD -クラナド-	
CLANNAD ～AFTER STORY～另一个世界 杏篇	CLANNAD ～AFTER STORY～もうひとつの世界 杏編	
悠久之翼	ef - a tale of memories.	悠久之翼,EF-THE FIRST TALE,EF-THE LATTER TALE,EF-A TALE OF MEMORIES,EF-A TALE OF MELODIES
悠久之翼2	ef - a tale of melodies.	悠久之翼,EF-THE FIRST TALE,EF-THE LATTER TALE,EF-A TALE OF MEMORIES,EF-A TALE OF MELODIES
Code Geass 反叛的鲁路修	コードギアス 反逆のルルーシュ	叛逆的鲁鲁修,叛逆的勒鲁什,Code Geass,反叛的鲁路修
Code Geass 反叛的鲁路修R2	コードギアス 反逆のルルーシュR2	叛逆的鲁鲁修,叛逆的勒鲁什,Code Geass,反叛的鲁路修
神薙	かんなぎ	神剃,かんなぎ,神薙
超时空要塞 Macross	超時空要塞マクロス	MACROSS,マクロスシリーズ,超时空要塞
超时空要塞 7	マクロス7	MACROSS,マクロスシリーズ,超时空要塞 7
超时空要塞 Frontier	マクロスFrontier	MACROSS,マクロスシリーズ,超时空要塞 Frontie
染红的街道	あかね色に染まる坂	
图书馆战争		図書館戦争
红 Kurenai	紅 Kurenai	红,红 Kurenai,紅 KURENAI
食灵-零-	喰霊-零-	食灵 零,食灵-零-,喰霊,喰霊-零-
H2O 赤砂的印记	H2O -FOOTPRINTS IN THE SAND-	
超智游戏		ONE OUTS - ワンナウツ
亡念之扎姆德		亡念のザムド
华丽的挑战	スキップ・ビート!	スキップビート！,华丽的挑战
深渊传说	テイルズ オブ ジ アビス	テイルズ オブ ジ アビス,TALES OF THE ABYSS
吸血鬼骑士	ヴァンパイア騎士	吸血鬼骑士,ヴァンパイア骑士,VAMPIRE KNIGHT
今天的5年2班	今日の5の2	今天的五年二班,今日的五年二班,今日の5の2
再造人卡辛		再造人卡夏
伯爵与妖精	伯爵と妖精	伯爵と妖精,伯爵与妖精
武装机甲	鉄のラインバレル	鉄のラインバレル,武装机甲
钢铁新娘	ケメコデラックス!	钢铁新娘,ケメコデラックス!
白虎	ヒャッコ	虎子,ヒャッコ,白虎
北斗神拳 第一季		北斗の拳,北斗之拳
北斗神拳 第二季		北斗の拳2,世紀末救世主伝説
北斗神拳 外传		北斗の拳,北斗之拳
黑塚	黒塚 KUROZUKA	黒塚 KUROZUKA
野良耳		のらみみ
无限之住人	無限の住人	无限之住人
药师寺凉子的怪奇事件簿	薬師寺涼子の怪奇事件簿	药师寺凉子,药师寺凉子的怪奇事件簿,薬師寺涼子の怪奇事件簿
西洋古董洋果子店	西洋骨董洋菓子店～アンティーク～	
毁灭世界的六人	ワールド・デストラクション 世界撲滅の六人	世界撲滅の六人,毁灭世界的六人
魔法使的注意事项	魔法遣いに大切なこと	魔法遣いに大切なこと,魔法使的注意事项
魔法使的注意事项 夏季的天空	魔法遣いに大切なこと 〜夏のソラ〜	魔法遣いに大切なこと 夏のソラ,魔法使的注意事项 夏季的天空
电波少女 第一部		MISSION-E,CODE-E
电波少女 第二部		MISSION-E,CODE-E
海马	カイバ	カイバ,海马
×××HOLiC	×××HOLiC	四月一日灵异事件簿,×××HOLiC
艾莉森与莉莉亚		アリソンとリリア
恶作剧之吻	イタズラなKiss	一吻定情,LOVE IN TOKYO,一吻定情2013
S.A特优生	S・A～スペシャル・エー～	S.A 优等生,S・A～スペシャル・エー～
二十面相少女	二十面相の娘	二十面相の娘,二十面相少女
我家有个狐仙大人	我が家のお稲荷さま。	我が家のお稲荷さま。,我が家のお稲荷さま
RD潜脑调查室	RD 潜脳調査室	RD潜脳調査室 アールディー,RD潜脑调查室
雨月	あまつき	あまつき,雨月
苍色骑士	BLASSREITER	BLASSREITER,苍色骑士
骷髅13		GOLGO13杀手,ゴルゴ13,杀手
狂乱家族日记		狂乱家族日記
假面女仆卫士	仮面のメイドガイ	仮面のメイドガイ,假面女仆卫士
幻影少年	モノクローム・ファクター	幻影少年,モノクローム・ファクター
企鹅娘		ペンギン娘はぁと
水晶之焰		クリスタル ブレイズ
偶像宣言 第一季		星梦天使,花漾明星KIRARIN,偶像革命
偶像宣言 第二季		星梦天使,花漾明星KIRARIN,偶像革命
星之海的爱玛丽		
死后文	シゴフミ	死后文,シゴフミ,亡者之信
你是主人我是仆	君が主で執事が俺で	你是主啊我是仆,君が主で執事が俺で
神枪少女	GUNSLINGER GIRL	神枪少女,枪姬,GUNSLINGER GIRL,ガンスリンガーガール
神枪少女 -IL TEATRINO-	GUNSLINGER GIRL -IL TEATRINO-	神枪少女,枪姬,GUNSLINGER GIRL,ガンスリンガーガール
破天荒游戏	破天荒遊戯	破天荒游戏
威尔贝鲁物语		
BUS GAMER		
全力兔子		全力ウサギ
濑户的花嫁	瀬戸の花嫁	
精灵守护者		精灵的守护人,精霊の守り人
奔向地球		地球へ…
英雄时代		ヒロイック・エイジ
魔女猎人	エル・カザド	エル・カザド,魔女猎人
大江户火箭		大江戸ロケット
机神大战巨型方程式		機神大戦ギガンティックフォーミュラ,
偶像大师 XENOGLOSSIA		アイドルマスター
青空下的约定	この青空に約束を	この青空に約束を,青空下的约定
蓝龙		BLUE DRAGON
鬼太郎		ゲゲゲの鬼太郎,GE GE GE的鬼太郎
星界死者之书	キスダム -ENGAGE planet-	キスダム -ENGAGE PLANET,星界死者之书
钢铁神吉克		鋼鉄神ジーグ
爆裂天使	ばくれつてんし	爆裂天使,ばくれつてんし
爆裂天使-INFINITY-	爆裂天使 ~インフィニティ~	爆裂天使,ばくれつてんし
天元突破 红莲螺岩	劇場版 天元突破グレンラガン 紅蓮螺巌篇	天元突破グレンラガン,天元突破
幸运星	らき☆すた	幸运星,らき☆すた
电脑线圈	電脳コイル	电脑线圈,電脳コイル
地球防卫少年	ぼくらの	地球便当少年
SOLA	sola	sola
蓝兰岛漂流记	ながされて藍蘭島	ながされてあいらんとう,蓝兰岛漂流记
怪物王女	怪物王女	怪物王女
光明之泪X风	シャイニング・ティアーズ・クロス・ウィンド	光明之泪,シャイニング ティアーズ,Shining Tears × Wind
小女神花铃	かみちゃまかりん	花铃的魔法戒CHU,かみちゃまかりん,小女神花铃
钢铁三国志		
桃华月惮	桃華月憚	桃华月惮
兽装机攻断空我NOVA		獣装機攻ダンクーガ ノヴァ
银河铁道物语		銀河鉄道物語
月光之旅		
悲惨世界 少女珂赛特	レ・ミゼラブル 少女コゼット	悲惨世界 少女珂赛特,レ・ミゼラブル 少女コゼット
校园乌托邦 学美向前冲！	がくえんゆーとぴあ まなびストレート!	校园乌托邦 学美向前冲！,がくえんゆーとぴあ まなびストレー
火箭女孩		
冬日花园		
东京魔人学园剑风帖 龙龙 第一季		
东京魔人学园剑风帖 龙龙 第二季		
神圣十月	Saint October	神圣十月,Saint October
月面兔兵器米娜		
新勇者莱汀		
VENUS VERSUS VIRUS 除魔维纳斯		VENUS VERSUS VIRUS,除魔维纳斯,维纳斯VS魔人
向日葵！ 第一季		忍者少女
向日葵！ 第二季		忍者少女
FLAG		
神灵狩	神霊狩/GHOST HOUND	神霊狩／GHOST HOUND,神灵狩
紫音之王	しおんの王	しおんの王,紫音之王
魔人侦探食脑奈罗		魔人探侦脳噛ネウロ
出租魔法使	レンタルマギカ	レンタルマギカ,魔法人力派遣公司,魔法使派遣会社
龙鸣		ドラゴノーツ -ザ・レゾナンス-
PRISM ARK	PRISM ARK	プリズムアーク,PRISM ARK
BLUE DROP 天使们的戏曲	BLUE DROP ～天使達の戯曲～	BLUE DROP,天使们的戏曲,百合
竹刀少女	バンブーブレード -BAMBOO BLADE-	BAMBOO BLADE,竹刀少女
MYSELF;YOURSELF		MYSELF;YOURSELF,マイセルフ ユアセルフ
逮捕令 第一季		警花逮捕令,たいほしちゃうぞ
逮捕令 第二季		逮捕しちゃうぞ 
逮捕令 第三季		警花逮捕令,たいほしちゃうぞ
逮捕令 OVA		警花逮捕令,たいほしちゃうぞ
素描簿	スケッチブック ～full color's～	素描本,スケッチブック ～full color's～
请别忧伤了二之宫君	ご愁傷さま二ノ宮くん	请别忧伤了二之宫君,ご愁傷さま二ノ宮くん,二之宫君
暗夜魔法使	ナイトウィザード The ANIMATION	暗夜魔法使,ナイトウィザード The ANIMATION
魂兽		AYAKASHI
MAPLESTORY		MXD,冒险岛,枫之谷
物怪	もっけ	もっけ,物怪
海绵宝宝 第四季		スポンジ・ボブ
萌单		もえたん
铁子之旅		鉄子の旅
永生之酒	BACCANO! （バッカーノ!）	永生之酒,BACCANO!,バッカーノ!,brain'sbase
天翔少女		スカイガールズ
扑杀天使 第一季		扑杀天使朵库萝
扑杀天使 第二季		撲殺天使ドクロちゃん2,扑杀天使朵库 第二季
僵尸借贷	ZOMBIE-LOAN	僵尸借贷,ZOMBIE-LOAN
零秒出手		BUZZER BEATER
KANON/华音	Kanon 東映版	雪之少女,华音,KANON,カノン
KANON/华音	Kanon	雪之少女,华音,KANON,カノン
家庭教师HITMAN REBORN!	家庭教師ヒットマンREBORN!	家庭教师,家庭教师HITMANREBORN,家庭教师杀手里包恩,家庭教师REBORN
少女爱上姐姐 	乙女はお姉さまに恋してる	少女爱上姐姐,乙女爱上姐姐,処女はお姉さまに恋してる,OTOBOKU
少女爱上姐姐 OVA 2人的Elder	乙女はお姉さまに恋してる 2人のエルダー	少女爱上姐姐,処女はお姉さまに恋してる,OTOBOKU
黑礁	BLACK LAGOON	BLACK LAGOON,企业佣兵
黑礁 第二季	BLACK LAGOON The Second Barrage	BLACK LAGOON,企业佣兵,黑礁
黑礁 第三季 Roberta’s Blood Trail	BLACK LAGOON Roberta’s Blood Trail	BLACK LAGOON,企业佣兵,黑礁
我们的存在	僕等がいた	我们的存在,僕等がいた,曾经的我们
蜂蜜与四叶草 电视剧		ハチミツとクローバー
传颂之物	うたわれるもの	うたわれるもの,受讚頌者,UTAWARERUMONO
惊爆草莓	ストロベリー・パニック	STRAWBERRY PANIC!,草莓危机
魔界战记 迪斯凯亚	魔界戦記ディスガイア	魔界战记,迪斯凯亚
仰望半月的夜空	半分の月がのぼる空	仰望半月的夜空,半分の月がのぼる空,上弦月的天空
复苏的天空 -救援之翼-	よみがえる空 -RESCUE WINGS-	复苏的天空,救援之翼
备长炭	びんちょうタン	备长炭
死神的歌谣	しにがみのバラッド。	死神的歌谣,しにがみのバラッド。
怪 〜AYAKASHI〜	怪 〜AYAKASHI〜	怪 AYAKASHI,怪 〜AYAKASHI〜,化猫
甜蜜声优	REC	甜蜜声优,REC
女生爱女生	かしまし 〜ガール・ミーツ・ガール〜	かしまし ガールミーツガール
阴守忍者	陰からマモル!	陰からマモル！
落语天女	落語天女おゆい	落語天女おゆい,落语天女
键姬物语 永久爱丽丝轮舞曲		鍵姫物語 永久アリス輪舞曲
柠檬天使计划	LEMON ANGEL PROJECT	柠檬天使计划,LEMON ANGEL PROJECT
结界师		
奇幻贵公子	ゴーストハント	奇幻贵公子,ゴーストハント
樱兰高校男公关部	桜蘭高校ホスト部	桜兰高校ホスト部
武装炼金	武装錬金	武装炼金,武装錬金
南瓜剪刀		陆军情报部三科
心跳回忆 ONLY LOVE	ときめきメモリアル Only Love	心跳回忆 ONLY LOVE,ときめきメモリアル Only 
工作狂人		働きマン
后天的方向	あさっての方向	后天的方向,あさっての方向
赐予护女神的祝福	護くんに女神の祝福を!	赐予护女神的祝福,護くんに女神の祝福を!
天保异闻妖奇士		
魔法先生捏吉！	魔法先生ネギま!	魔法老师涅吉,魔法老师涅吉！,涅吉！？
魔法老师涅吉!?	ネギま!?	魔法老师涅吉,魔法老师涅吉！,涅吉！？,ネギま!?
调酒师		
永不消失的彩虹		
夜明前的琉璃色	夜明け前より瑠璃色な ～Crescent Love～	夜明け前より瑠璃色な,更胜夜明前的琉璃色,夜明前的琉璃色
不公正抽签		不平衡抽签,KUJIBIKI UNBALANCE
Happiness!	はぴねす!	はぴねす！,爱与魔法,Happiness!
月桂树的王子们	マージナルプリンス ～月桂樹の王子達～	
苍天之拳		
甜蜜偶像	らぶドル ～Lovely Idol～	甜蜜偶像,らぶドル ～Lovely Idol～
银色的奥林西斯		
流星之洛克人		
东京暴走族		
兽爪		
贫穷姐妹物语	貧乏姉妹物語	びんぼうしまいものがたり,贫穷姐妹物语
童话枪手小红帽		
黑血兄弟		
无罪的维纳斯	イノセント・ヴィーナス	无罪的维纳斯,イノセント・ヴィーナス
娇蛮之吻	つよきす Cool×Sweet	娇蛮之吻,つよきす Cool×Sweet
恋之魔法波波糖		MAMOTTE LOLLIPOP,开心魔法变
太阳默示录		
莉莉和青蛙和弟弟		
ZEGAPAIN		ZEGAPAIN
校园迷糊大王	スクールランブル	SCHOOL RUMBLE,恶搞校园,喧嚣学院,スクールランブル,校园迷糊大王
魔女之刃	ウィッチブレイド	魔女之刃,ウィッチブレイド
我的女神	ああっ女神さまっ	我的女神,ああっ女神さまっ,幸运女神,幸運女神
我的女神 缤纷之翼	ああっ女神さまっ それぞれの翼	我的女神,ああっ女神さまっ,幸运女神,幸運女神,我的女神 缤纷之翼
我的女神 OVA	ああっ女神さまっ OVA	我的女神,ああっ女神さまっ,幸运女神,幸運女神
妖逆门		
炼金三级魔法少女	錬金3級 まじかる?ぽか～ん	
神样家族	神様家族	神样家族
犬神！		
兽王星	獣王星	兽王星
西蒙 SIMOUN		
翼·年代记	ツバサ・クロニクル	ツバサ,TSUBASA翼,TSUBASA,翼年代记
翼·年代记 第二部	ツバサ・クロニクル 第2シリーズ	ツバサ,TSUBASA翼,TSUBASA,翼年代记,翼·年代记
公主公主	プリンセス・プリンセス	公主公主,プリンセス・プリンセス,变身男孩
学园天堂	学園ヘヴン	学园天堂,学園ヘヴン
飞轮少年	エア·ギア	飞轮少年
玻璃舰队		
暗夜第六感	NIGHT HEAD GENESIS	暗夜第六感,暗夜起源
苍之瞳的少女	ザ・サード 〜蒼い瞳の少女〜	苍之瞳的少女,ザ・サード 〜蒼い瞳の少女〜
机神咆吼	機神咆吼デモンベイン	机神咆吼,機神咆吼デモンベイン
魂链		
梦使		
不可思议星球的双胞胎公主 第一季		神秘星球孪生公主,不可思议星球的孪生公主,双子星公主
格斗美神武龙		
声优白皮书		
小心啊公主		公主请小心
洛克人EXE		ロックマンエグゼ
怪医美女RAY		
女子高中生		
女子高中生		
圣剑使的禁咒咏唱	聖剣使いの禁呪詠唱	聖剣使いの禁呪詠唱
Falcom学园	みんな集まれ! ファルコム学園	みんな集まれ！ファルコム学園
大家集合！Falcom学园 2期	みんな集まれ! ファルコム学園 SC	みんな集まれ！ファルコム学園第2期,大家集合起来！FALCOM学园 第二季
纯洁的玛利亚	純潔のマリア	纯洁的玛利亚,純潔のマリア
夜之小双侠	夜ノヤッターマン	夜ノヤッターマン,夜之小双侠
无头骑士异闻录×2 承	デュラララ!!×2 承	デュラララ!!×2 承
偶像大师 灰姑娘女孩	アイドルマスター シンデレラガールズ	アイドルマスター シンデレラガールズ,偶像大师灰姑娘女孩
铳皇无尽的法夫纳	銃皇無尽のファフニール	銃皇無尽のファフニール
路人女主的养成方法	冴えない彼女の育てかた	路人女主的养成方法,不起眼女主角培育法,冴えない彼女の育てかた
军人少女	みりたり!	军人少女,みりたり！
血型君2	血液型くん!2	血液型くん！2
美男高校地球防卫部LOVE！	美男高校地球防卫部LOVE！,美男高校地球防衛部LOVE！,美男高校	美男高校地球防卫部LOVE！,美男高校地球防衛部LOVE！
元气少女缘结神◎	神様はじめました◎	元气少女缘结神,神様はじめました
绝对双刃	アブソリュート・デュオ	绝对双刃,アブソリュート·デュオ,ABSOLUTE DUO
ISUCA	ISUCA	ISUCA 依丝卡,イスカ,ISUCA-イスカ-,依丝卡
动画心疗系	アニメで分かる心療内科	漫画心疗系,アニメで分かる心療内科
关于完全听不懂老公在说什么的事 第一季	旦那が何を言っているかわからない件	旦那が何を言っているかわからない件,关公说事,关于老公
魔法少女奈叶	魔法少女リリカルなのは	
魔法少女奈叶A's	魔法少女リリカルなのはA's	
魔法少女奈叶StrikerS	魔法少女リリカルなのはStrikerS	
魔法少女奈叶ViVid	魔法少女リリカルなのはViVid	魔法少女リリカルなのはVIVID,魔法少女奈叶VIVID
我的青春恋爱物语果然有问题	やはり俺の青春ラブコメはまちがっている。	BrainsBase,果然我的青春恋爱喜剧是错误,ぽんかん⑧,やはり俺の青春ラブコメはまちがっている,我的青春恋爱物语果然有问题。,果然我的青春恋爱喜剧搞错了
我的青春恋爱物语果然有问题 续	やはり俺の青春ラブコメはまちがっている。続	我的青春恋爱物语果然有问题,BrainsBase,果然我的青春恋爱喜剧是错误,ぽんかん⑧,やはり俺の青春ラブコメはまちがっている
吹响吧！上低音号	響け！ユーフォニアム	吹响吧！上低音号,響け！ユーフォニアム,吹响！悠风号
御神乐学园组曲	ミカグラ学園組曲	御神乐学园组曲,ミカグラ学園組曲
雨色可可	雨色ココア	雨色ココア,雨色可可
亚尔斯兰战记	アルスラーン戦記	アルスラーン戦記,亚尔斯兰战记
可塑性记忆	プラスティック・メモリーズ	可塑性记忆,Plastic Memories,プラスティック・メモリーズ
幻界战线	血界戦線	幻界战线,KEKKAI SENSEN
枪神斯托拉塔斯	ガンスリンガーストラトス	
终结的炽天使	終わりのセラフ	终结的炽天使,终わりのセラフ
吸血鬼福尔摩斯	VAMPIRE HOLMES	VAMPIRE HOLMES,吸血鬼福尔摩斯
长门有希酱的消失	長門有希ちゃんの消失	长门有希的消失,長門有希ちゃんの消失,长门有希酱的消失
食戟之灵	食戟のソーマ	食戟之灵,食戟のソーマ
歌之☆王子殿下 真爱1000%	うたの☆プリンスさまっ♪ マジLOVE1000%	うたの☆プリンスさまっ♪,歌之王子殿下,歌之☆王子殿下,歌之☆王子殿下 真爱1000%
歌之☆王子殿下 真爱2000%	うたの☆プリンスさまっ♪ マジLOVE2000%	歌之☆王子殿下,うたの☆プリンスさまっ♪,歌之☆王子殿下 真爱2000%,歌之王子殿下 第二季
歌之☆王子殿下 真爱REVOLUTIONS	うたの☆プリンスさまっ♪ マジLOVEレボリューションズ	歌之王子殿下,歌之☆王子殿下,うたの☆プリンスさまっ♪ ,マジLOVEレボリューションズ,歌之王子殿下 真爱革命
攻壳机动队 STAND ALONE COMPLEX	攻殻機動隊 STAND ALONE COMPLEX	GHOST IN THE SHELL,STAND ALONE COMPLEX,攻壳机动队,攻壳
攻壳机动队 S.A.C. 2nd GIG	攻殻機動隊 S.A.C. 2nd GIG	攻殻機動隊S.A.C 2ND GIG,攻壳机动队第二季,攻壳
攻壳机动队 S.A.C. SSS 3D	攻殻機動隊 S.A.C. SOLID STATE SOCIETY 3D	GHOST IN THE SHELL,STAND ALONE COMPLEX,攻壳机动队
攻壳机动队2 无罪	イノセンス	GHOST IN THE SHELL,STAND ALONE COMPLEX,攻壳机动队,攻壳机动队2 无罪
攻壳机动队ARISE ALTERNATIVE ARCHITECTURE	攻殻機動隊ARISE ALTERNATIVE ARCHITECTURE	GHOST IN THE SHELL,STAND ALONE COMPLEX,攻壳机动队
怪盗JOKER 第一季	怪盗ジョーカー	怪盗JOKER,怪盗ジョーカー
怪盗JOKER 第二季	怪盗ジョーカー シーズン2	怪盗ジョーカー,怪盗Joker
黏黏糊糊！！角质君 第一季		にゅるにゅる！！KAKUSENくん
黏黏糊糊！！角质君 第二季		にゅるにゅる!!KAKUSENくん2期
伪恋	ニセコイ	伪恋,ニセコィ
伪恋：	ニセコイ:	伪恋：,ニセコイ:,伪恋 第二季
伪恋 OAD	ニセコイ OAD	伪恋,ニセコィ
希德尼娅的骑士 第一季	シドニアの騎士	シドニアの騎士,KNIGHTS OF SIDONIA
希德尼娅的骑士 第二季	シドニアの騎士 第九惑星戦役	シドニアの騎士 第九惑星戦役,希德尼娅的骑士 第九惑星战役
摸索吧！部活剧	てさぐれ！部活もの	てさくれ！部活もの,てさぐれ！部活もの,摸索吧！部活剧
摸索吧！部活剧 再来一个	てさぐれ!部活もの あんこーる	てさくれ！部活もの,てさぐれ！部活もの,摸索吧！部活剧 再来
摸索吧！部活剧 第三季	てさぐれ！部活もの すぴんおふ プルプルんシャルムと遊ぼう	てさくれ！部活もの,てさぐれ！部活もの,摸索吧！部活剧 第三
Fate/stay night [Unlimited Blade Works] 第一季	Fate/stay night [Unlimited Blade Works]	Fate,UBW,FSN UBW,UNLIMITED BLADE WORKS,无限剑制
Fate/stay night [Unlimited Blade Works] 第二季	Fate/stay night [Unlimited Blade Works] 2ndシーズン	UBW,FSN/UBW,UNLIMITED BLADE WORKS,无限剑制
罪恶王冠	ギルティクラウン	罪恶王冠,Guilty Crown,原罪之冠,ギルティクラウン
罪恶王冠 SP	ギルティクラウン SP	Guilty Crown,原罪之冠,罪之王冠,ギルティクラウン
战国BASARA	戦国BASARA	战国BASARA,戦国BASARA
战国BASARA 贰	戦国BASARA 弐	戦国BASARA 弐,战国BASARA 贰,战国BASARA
战国BASARA Judge End	戦国BASARA Judge End	戦国BASARA JUDGE END,战国BASARA第三季
搞笑漫画日和	ギャグマンガ日和	搞笑漫画日和,噱头漫画日和,ギャグマンガ
搞笑漫画日和2	ギャグマンガ日和2	搞笑漫画日和,日和2,噱头漫画日和,ギャグマンガ
搞笑漫画日和3	ギャグマンガ日和3	搞笑漫画日和,日和3,噱头漫画日和,ギャグマンガ
搞笑漫画日和＋	ギャグマンガ日和＋	搞笑漫画日和,日和4,噱头漫画日和,ギャグマンガ,搞笑漫画日和＋
浦和小调	浦和の調ちゃん	浦和の調ちゃん
来自新世界	新世界より	新世界より,来自新世界
灼眼的夏娜	灼眼のシャナ	灼眼のシャナ,夏娜,灼眼の夏娜
灼眼的夏娜II -Second-	灼眼のシャナII -Second-	灼眼のシャナ,夏娜,灼眼の夏娜
灼眼的夏娜III -Final-	灼眼のシャナIII -Final-	灼眼のシャナ,夏娜,灼眼の夏娜
灼眼的夏娜S	灼眼のシャナS	灼眼のシャナ,夏娜,灼眼の夏娜
灼眼的夏娜 OVA 恋爱与温泉的校外学习！	灼眼のシャナ特別編 “恋と温泉の校外学習!”	灼眼のシャナ,夏娜,灼眼の夏娜
灼眼的夏娜 剧场版	劇場版 灼眼のシャナ	灼眼のシャナ,夏娜,灼眼の夏娜
天地无用!	天地無用!	天地無用,天地无用
新・天地无用!	新・天地無用!	天地無用,天地无用
魔法少女砂沙美	魔法少女プリティサミー	 魔法少女プリティサミー,魔法少女砂沙美
天地无用! GXP	天地無用! GXP	天地無用！GXP,天地无用 GXP
爱·天地无用！	愛・天地無用!	愛・天地無用！,爱天地无用
天地无用！ 剧场版		天地無用,天地无用
黑子的篮球	黒子のバスケ	黑子的篮球,黒子のバスケ
黑子的篮球 第2期	黒子のバスケ 第2期	黑子的篮球,黒子のバスケ
黑子的篮球 第3期	黒子のバスケ 第3期	黑子的篮球,黒子のバスケ 第3期
新世纪福音战士 剧场版 THE END OF EVANGELION	新世紀エヴァンゲリオン劇場版 THE END OF EVANGELION	EVA,天鹰战士,Evangelion,新世纪福音战士,新世纪エヴァンゲリオン,Air 真心为你
DOG DAYS	DOG DAYS	DOG DAYS,狗日
DOG DAYS''	DOG DAYS''	DOG DAYS,狗日,DOG DAYS''
新世纪福音战士	新世紀エヴァンゲリオン	EVA,天鹰战士,Neon Genesis Evangelion,新世紀エヴァンゲリオン
新世纪福音战士剧场版 死与新生	新世紀エヴァンゲリオン劇場版 シト新生	EVA,天鹰战士,Evangelion,新世纪福音战士,新世纪エヴァンゲリオン,死与新生
新世纪福音战士 新剧场版：序	ヱヴァンゲリヲン 新劇場版:序	EVA,天鹰战士,Neon Genesis Evangelion,新世纪福音战士,新世纪エヴァンゲリオン,EVA 序
新世纪福音战士 新剧场版：破	ヱヴァンゲリヲン 新劇場版:破	EVA,天鹰战士,Neon Genesis Evangelion,新世纪福音战士,新世纪エヴァンゲリオン,EVA 破
新世纪福音战士 新剧场版：Q	ヱヴァンゲリヲン 新劇場版:Q	EVA,天鹰战士,Neon Genesis Evangelion,新世纪福音战士,新世纪エヴァンゲリオン,EVA Q
Fate/Zero 第一季	Fate/Zero	FateZero,FATE ZERO,FZ,F/Z
热风海陆BUSHIROAD	熱風海陸ブシロード	热风海陆,熱風海陸ブシロード,热风海陆BUSHIROAD,热
关于完全听不懂老公在说什么的事 第二季	旦那が何を言っているかわからない件 2スレ目	关公说事,关于完全听不懂老公在说什么的事
无头骑士异闻录	デュラララ!!	デュラララ!!,DURARARA!!,DRRR,DRRR!!,brainsbase
宇宙兄弟	宇宙兄弟	宇宙兄弟,うちゅうきょうだい
战国无双	戦国無双	戦国無双,战国无双
Code Geass GAIDEN 亡国的阿基德	コードギアス 亡国のアキト	亡国的阿基德,コードギアス,亡国のアキト
夏目友人帐	夏目友人帳	夏目友人帐,夏目友人帳,brainsbase
续 夏目友人帐	続 夏目友人帳	夏目友人帐,夏目友人帳,续 夏目友人帐,brainsbase
夏目友人帐 参	夏目友人帳 参	夏目友人帐,夏目友人帳,brainsbase
夏目友人帐 肆	夏目友人帳 肆	夏目友人帐,夏目友人帳,brainsbase
BLACK★ROCK SHOOTER	ブラック★ロックシューター	BRS, ブラック★ロックシューター,B★RS,BLACK ROCK SHOOTER,黑岩射手
BLACK★ROCK SHOOTER OVA	ブラック★ロックシューター	BRS, ブラック★ロックシューター,B★RS,BLACK ROCK SHOOTER,黑岩射手
通灵男孩诺曼		超凡的诺曼
黑魔女学园		黒魔女さんが通る!!
恋爱研究会！～我们变成动画啦！～		こいけん！～私たちアニメになっちゃった～
宝石宠物 第七季		宝石宠物 MAGICAL CHANGE
龙与虎	とらドラ!	とらドラ!,TORADORA,龙与虎
竖笛与双肩书包 第一季		竖笛与双肩包,竖笛与双肩背包
竖笛与双肩书包 第二季		竖笛与双肩包,竖笛与双肩背包
竖笛与双肩书包 第三季		リコーダーとランドセル ミ☆
竖笛与双肩书包 OAD		竖笛与双肩包,竖笛与双肩背包
天然萌少女明日香	今日のあすかショー	天然萌少女明日香
你好七叶 第一季	はいたい七葉	はいたい七叶,HAITAI七叶,你好七叶
你好 七叶 第二季		はいたい七叶,HAITAI七叶
怪诞小镇	怪奇ゾーン グラビティフォールズ	GRAVITY FALLS,怪奇ゾーン グラビティフォールズ,怪诞小镇
怪诞小镇 2	怪奇ゾーン グラビティフォールズ 2	GRAVITY FALLS,怪奇ゾーン グラビティフォールズ,怪诞小镇
军火女王 第一季	ヨルムンガンド	ヨルムンガンド
军火女王 PERFECT ORDER	ヨルムンガンド PERFECT ORDER	ヨルムンガンド,军火女王
荔枝☆光俱乐部		
萌菌物语 Returns	もやしもん リターンズ	农大菌物语,萌菌物語RETURN,萌菌物语
战斗之魂 第七季		バトルスピリッツ烈火魂,战斗之魂BURNING SOUL,战斗之魂 烈火灵魂
那年那兔那些事儿 第一季		那年那兔那些事儿
侦探歌剧 少女福尔摩斯	探偵オペラ ミルキィホームズ	探侦オペラ,　 ミルキィホームズ,侦探歌剧：少女福尔摩斯,侦探歌剧,MILKY HOLMES,探偵オペラ ミルキィホームズ
侦探歌剧 少女福尔摩斯 第二幕	探偵オペラ ミルキィホームズ 第2幕	探侦オペラ,　 ミルキィホームズ,侦探歌剧：少女福尔摩斯,侦探歌剧,MILKY HOLMES,探偵オペラ ミルキィホームズ
两个人是少女福尔摩斯	ふたりはミルキィホームズ	ふたりはミルキィホームズ,两个人是少女福尔摩斯,Milky Holmes 第三幕
纸箱战机 第一部		纸箱战机W
PUNKISS！2次元	ぱんきす!2次元	ぱんきす！2次元
四月是你的谎言	四月は君の嘘	四月是你的谎言,四月は君の嘘
王牌御史		王牌
希德尼娅的骑士 剧场版	劇場版 シドニアの騎士	シドニアの騎士,KNIGHTS OF SIDONIA
攻壳机动队	GHOST IN THE SHELL / 攻殻機動隊	GHOST IN THE SHELL,STAND ALONE COMPLEX,攻壳机动队
吃饭睡觉打豆豆		《吃饭睡觉打豆豆》,豆豆动画之吃饭睡觉打豆豆
我的三体		《我的三体》
攻壳机动队 S.A.C. Solid State Society	攻殻機動隊 STAND ALONE COMPLEX Solid State Society	攻殻機動隊S.A.C 2ND GIG,攻壳机动队 S.A.C
攻壳机动队 S.A.C 剧场版：2.0	GHOST IN THE SHELL / 攻殻機動隊2.0	GHOST IN THE SHELL,STAND ALONE COMPLEX,攻壳机动队
光之美少女 第七季		霹雳Q娃,美丽祭祀,PRECURE,PRETTY CURE,プリキュア,微笑Q娃,心跳Q娃,光之美少女DOKIDOKI,DOKIDOKI,ふたりはプリキュア
光之美少女 第十季		心跳！光之美少女
光之美少女 第十一季		霹雳Q娃,美丽祭祀,PRECURE,PRETTY CURE,プリキュア,微笑Q娃,心跳Q娃,光之美少女DOKIDOKI,DOKIDOKI,ふたりはプリキュア
攻壳机动队 笑面男	攻殻機動隊 STAND ALONE COMPLEX the Laughing Man,攻壳机动队 笑面男	GHOST IN THE SHELL,STAND ALONE COMPLEX,攻壳机动队
攻壳机动队 个别的十一人	攻殻機動隊 S.A.C. 2nd GIG Individual Eleven,攻壳机动队 个别的十一人	GHOST IN THE SHELL,STAND ALONE COMPLEX,攻壳机动队
虫师	蟲師	むしし,MUSHISHI
游☆戏☆王 5D's 第一季	遊☆戯☆王 ファイブディーズ	游戏王,YU-GI-OH!,遊戯王,游☆戏☆王,游戏王5D\\'S,遊☆戯☆王 ファイブディーズ,打牌王
游☆戏☆王 5D's 第二季	遊☆戯☆王 ファイブディーズ	游戏王,YU-GI-OH!,遊戯王,游☆戏☆王,游戏王5D\\'S,遊☆戯☆王 ファイブディーズ,打牌王
游☆戏☆王 5D's 第四季	遊☆戯☆王 ファイブディーズ	游戏王,YU-GI-OH!,遊戯王,游☆戏☆王,游戏王5D\\'S,遊☆戯☆王 ファイブディーズ,打牌王
游☆戏☆王 5D's 第三季	遊☆戯☆王 ファイブディーズ	游戏王,YU-GI-OH!,遊戯王,游☆戏☆王,游戏王5D\\'S,遊☆戯☆王 ファイブディーズ,打牌王
游☆戏☆王 5D's OVA 进化的决斗！星尘龙 VS 真红魔龙	遊☆戯☆王 5D's 進化する決闘! スターダスト VS レッド・デーモンズ	游戏王,YU-GI-OH!,遊戯王,游☆戏☆王,游戏王5D\\'S,遊☆戯☆王 ファイブディーズ,打牌王
BUDDY COMPLEX	バディ・コンプレックス	BUDDY COMPLEX,バディ・コンプレックス,心灵盟友
变形金刚 领袖之证 美版第一季		变形金刚 Prime
变形金刚 领袖之证 美版第二季		变形金刚 Prime
变形金刚 领袖之证 日版		变形金刚 Prime
我的战斗&龙收藏		オレカバトル＆ドラゴンコレクション
迷你偶像 2期	ぷちます!!‐プチプチ・アイドルマスター‐	小小偶像大师,迷你偶像大师,迷你偶像
史上最强弟子兼一		史上最强の弟子ケンイチ,
团地友夫		住宅区友夫,団地ともお
VIVIDRED OPERATION	ビビッドレッド・オペレーション	绯色战姬,VIVIDRED·OPERATION,ビビッドレッド・オペレーション
幻想嘉年华	カーニバル・ファンタズム	幻想嘉年华,カーニバル・ファンタズム,TAKE MOON,型月
罗小黑战记		罗小黑
当心蝙蝠侠		
功夫熊猫盖世传奇 第一季		功夫熊猫非凡传奇
功夫熊猫盖世传奇 第二季		功夫熊猫非凡传奇
功夫熊猫盖世传奇 第三季		功夫熊猫非凡传奇
英国一家 吃在日本	英国一家, 日本を食べる	英国一家,吃在日本
昭和物语		
闪电十一人		イナズマイレブン,INAZUMA ELEVEN,閃電十一人,雷门十一人,闪电十一人GO,イナズマイレブンGO
马达加斯加的企鹅 第一季		
马达加斯加的企鹅 第二季		
究极KERORO 奇迹的时空岛		军曹大电影5
探险活宝	Adventure Time season 1	探险时间,探险活宝,探险时光,Adventure Time season
探险活宝 第三季	Adventure Time season 3	探险时间,探险活宝,探险时光,Adventure Time 
探险活宝 第四季	Adventure Time season 4	探险时间,探险活宝,探险时光
探险活宝 第五季	Adventure Time season 5	探险时间,探险活宝,探险时光
ADVENTURE TIME 第六季		探险时间,探险活宝,探险时光,ADVENTURE TIME
很帅很可爱宣言		很帅很可爱,可爱大宣言
星系保卫战		
文学少女	文学少女	文少
异世界的圣机师物语	異世界の聖機師物語	
鬼妈妈		
虽然是玻璃假面 05版		玻璃假面
虽然是玻璃假面 2013版		玻璃假面
机巧魔神		
仓鼠管家	おるちゅばんエビちゅ	仓鼠管家,おるちゅばんエビちゅ,Ebichu
重金属摇滚双面人		
魔角侦探 第一季		
魔角侦探 第二季		
寒蝉鸣泣之时 解	ひぐらしのなく頃に解	寒蝉,ひぐらしのなく顷に,寒蝉鸣泣之时礼,寒蝉鸣泣之时煌,寒蝉鸣泣之时解
寒蝉鸣泣之时 礼	ひぐらしのなく頃に礼	寒蝉,ひぐらしのなく顷に,寒蝉鸣泣之时礼,寒蝉鸣泣之时煌,寒蝉鸣泣之时解
寒蝉鸣泣之时 煌	ひぐらしのなく頃に煌	寒蝉,ひぐらしのなく顷に,寒蝉鸣泣之时礼,寒蝉鸣泣之时煌,寒蝉鸣泣之时解
斗牌传说		闘牌伝説
IGPX		アイジーピーエックス
CANVAS2 七彩的素描		CANVAS
银盘万花筒	銀盤カレイドスコープ	银盘万花筒,銀盤カレイドスコープ
极速方程式		CAPETA カペタ
到另一个你的身边去		ノエイン もうひとりの君へ
兽装机攻断空我		兽装机攻
柔和三国志冲刺!!吕布子		
杀戮公主	MURDER PRINCESS	Murder_Princess,虐杀姬
CANDY BOY	Candy☆Boy	CANDYBOY
再见绝望先生	さよなら絶望先生	绝望老师,さよなら絶望先生,再见绝望先生
俗・再见绝望先生	俗・さよなら絶望先生	绝望老师,さよなら絶望先生,俗・さよなら絶望先生,俗・再见绝望先生
忏・再见绝望先生	懺・さよなら絶望先生	绝望老师,さよなら絶望先生,懺・さよなら絶望先生,忏・再见绝望先生
太昊伏羲		伏羲
超蛙战士		超蛙
抗日英雄杨来西		抗日小英雄杨来西
蓝猫龙骑团 希望家园		龙骑团,恐龙龙骑团
蓝猫龙骑团 TV		龙骑团,恐龙龙骑团
后羿射日		星猫大剧场之后羿射日,星猫大剧场
拯救侏罗纪		星猫历险记之拯救侏罗纪
蔬果王国历险记		蔬果王国
太空堡垒 第一季		ROBOTECH
太空堡垒 第二季		ROBOTECH
太空堡垒 第三季		ROBOTECH
欢迎加入NHK！	N・H・Kにようこそ!	欢迎来到NHK！,WELCOME TO THE NHK,N.H.Kにようこそ！
地上最强新娘	すもももももも ～地上最強のヨメ～	地上最强新娘,すもももももも ～地上最強のヨメ～
最终兵器彼女	最終兵器彼女	最终兵器彼女,最終兵器彼女
牙-KIBA	牙 -KIBA-	
AIR	AIR	鸟之诗,青空,AIR
蓝猫淘气3000问 幽默舞台		蓝猫
蓝猫淘气3000问 恐龙时代		蓝猫
蓝猫淘气3000问 星际大战		蓝猫
蓝猫淘气3000问 海洋世界		蓝猫
蓝猫淘气3000问 运动系列		蓝猫
蓝猫淘气3000问 太空历险		蓝猫
勇者王GAOGAIGAR		勇者王
舞-乙HIME		舞乙HIME,人肉高达,姬动战士高达
魔豆传奇	魔豆奇伝パンダリアン	魔豆奇伝パンダリアン,魔豆传奇
变形金刚 银河之力		トランスフォーマー
我们的仙境		HEARTFUL DAYS
帕塔利洛西游记		パタリロ西遊記！
新释·真田十勇士	新釈 眞田十勇士	真田十勇士
魔兵传奇		
武器种族传说	エレメンタル ジェレイド	エレメンタル ジェレイド
机兽起源	ゾイドジェネシス	机兽起源
LOVELESS	LOVELESS	LOVELESS,无爱之战,ラブレス
我的主人爱作怪	これが私の御主人様	これが私の御主人様
机动新撰组 萌之剑		機動新撰組 萌えよ剣
麟光之翼		リーンの翼
凉风	涼風	涼風,凉风
不可思议的教室		ぱにぽにだっしゅ！
欢乐七福娘		はっぴぃセブ ざ・テレビまんが
波子汽水		波子
增血鬼果林	かりん	增血鬼果林
曙光少女		SOLTY REI
出云战记	IZUMO -猛き剣の閃記-	IZUMO,出云战记
天使心		エンジェル・ハート,ANGEL HEART
王牌鉴定人		
人机续篇		
星舰驾驶员		
异度传说		
甲贺忍法帖	バジリスク ～甲賀忍法帖～	甲贺忍法帖,バジリスク ～甲賀忍法帖～
草莓棉花糖	苺ましまろ	莓乱扔
鸦KARAS	鴉 -KARAS-	鸦KARAS,鴉 -KARAS-
神是中学生	かみちゅ!	神是中学生,かみちゅ!
极上学生会	極上生徒会	極上生徒会
老婆是魔法少女	奥さまは魔法少女	奥様は魔法少女/おくさまはまほうし,老婆是魔法少女
极限女孩		アルティメットガール
枪心剑刃	ガン×ソード	枪与剑,枪心剑刃,ガン×ソード
草莓100%		草莓百分百
心动的日子		
苍穹之法芙娜	蒼穹のファフナー	蒼穹のファフナー,苍穹之战神,苍穹的法芙娜
微笑的闪士	グレネーダー ~ほほえみの闪士~	微笑的闪士
混沌武士	サムライチャンプルー	SAMURAI CHAMPLOO,混沌武士
神无月的巫女	神無月の巫女	神无月の巫女,kannazuki no miko 
库拉乌幻之记忆	KURAU Phantom Memory	幻之记忆,KURAU PHANTOM MEMORY,库拉乌幻
诗∽片		うた∽かた
人鱼的旋律	マーメイドメロディーぴちぴちピッチ	ぴちぴちピッチピュア,真珠美人鱼,唱K小鱼仙,マーメイドメロディー
人鱼的旋律Pure	マーメイドメロディー ぴちぴちピッチ ピュア	ぴちぴちピッチピュア,真珠美人鱼,唱K小鱼仙,マーメイドメロディー
吟游默示录	吟遊黙示録マイネリーベ	吟遊黙示録マイネリーベ
吟游默示录 wieder	吟游默示录,吟游默示录 wieder,吟遊黙示録マイネリーベ wieder	吟遊黙示録マイネリーベ
公主时间	W〜ウィッシュ〜	公主的时间,W～ウィッシュ～,W~WISH~,W-WISH
拳王创世纪		热拳本色,リングにかけろ
遥远时空中 八叶抄	遙かなる時空の中で —八葉抄—	遥远时空中,遙かなる時空の中で,遥远时空中 八叶抄
遥远时空中 紫阳花物语	遙かなる時空の中で —紫陽花ゆめ語り—	遥远时空中,遙かなる時空の中で,遥远时空中 紫阳花物语
遥远时空中 舞一夜	遙かなる時空の中で 舞一夜	遥远时空中,遙かなる時空の中で,遥远时空中 舞一夜
砂和尚		砂ぼうず
日式面包王	焼きたて!!ジャぱん	焼きたて!!ジャぱん,日式面包王
次元舰队	ジパング	ジパング,次元舰队
奇幻旅程		ファンタジックチルドレン,奇幻儿童
岩窟王	岩窟王	巌窟王,岩窟王
风-心之呼吸-		WIND -A BREATH OF HEART-
女生万岁 first season	GIRLSブラボー first season	GIRLSブラボー,女孩万岁
女生万岁 second season	GIRLSブラボー second season	GIRLSブラボー,女生万岁 第二季
DEARS 亲爱一族	DearS	DEARS,亲爱一族
御伽草子	お伽草子	お伽草子,御伽草子
仙境传说	RAGNAROK THE ANIMATION	仙境传说,RAGNAROK
老师的时间		せんせいのお時間
忘却的旋律		忘却の旋律
恋风	恋風	恋風,恋风
玛德莱克丝	MADLAX	MADLAX,マドラックス,玛德莱克丝
火鸟		火の鳥
陆奥圆明流外传 修罗之刻		陸奥圓明流外伝 修羅の刻
宝贝我爱你★★		愛してるぜベイベ★★,我爱你BABY
美鸟日记		美鳥の日々,美鸟伴身边,美鸟的每一天
苏生龙王传说		レジェンズ 甦る竜王伝説
七武士	Samurai 7	SAMURAI7,サムライセブン,七武士
MONSTER	MONSTER	MONSTER,モンスター,怪物
怪医黑杰克 前作		ブラック・ジャック,BLACK JACK
怪医黑杰克 OVA2		ブラック・ジャック,BLACK JACK
向北		北へ,DIAMOND DUST DROPS
极道鲜师（TV动画）		ごくせん
战区88	エリア88	エリア88,AREA 88,空战88区
光与水的女神		光と水のダフネ
妄想代理人	妄想代理人	もうそうだいりにん,PARANOIA AGENT
月咏-MOON PHASE-		月詠,月詠 -MOON PHASE-,MOON PHASE
爱丽丝学园	学園アリス	学園アリス,爱丽丝学园
舞-HIME		
天上天下		TIANSHANGTIANXIA
BECK		
爱情泡泡糖	Φなる・あぷろーち	FINAL APPROACH,Φなる・あぷろーち,爱情泡泡糖
绚烂舞踏祭	絢爛舞踏祭 ザ・マーズ・デイブレイク	絢爛舞踏祭,ザ・マーズ・デイブレイク,绚烂舞踏祭
落叶		
小魔女蒙娜		
阴阳大战记	陰陽大戦記	阴阳大战记
蝙蝠侠传奇		新蝙蝠侠
蝙蝠侠传奇		新蝙蝠侠
LOVE♥LOVE	LOVE♥LOVE?	ラブラブ,LOVE♥LOVE？
勇午交涉人		勇午,勇午～交渉人～
风人物语	風人物語	風人物語,风人物语
酷伊忍者传		ニニンがシノブ伝
双恋		
双恋 Alternative		
TO HEART 第一季		
TO HEART Remember my memories		TO HEART〜回忆永恒〜,永恒回忆
银河天使		ギャラクシーエンジェル,GA,GALAXY ANGEL,银河天使队
银河天使Z		ギャラクシーエンジェルZ 
银河天使A/AA/S		ギャラクシーエンジェル 第3期,银河天使A,银河天使AA,银河天使S
银河天使X		ギャラクシーエンジェルX 第4期
十兵卫		十兵衛ちゃん,十兵卫 ～心形眼罩的秘密～
十兵卫2～西伯利亚柳生的逆袭～		十兵衛ちゃん2～シベリア柳生の逆襲～
超重神GRAVION		超重神グラヴィオン
超重神GRAVION Zwei（第二季）		超重神グラヴィオンツヴァイ
铁人28号		鉄人28号
铁人28号		鉄人28号
铁人28号		鉄人28号
铁人28号		鉄人28号2004年版
铁人28号		鉄人28号
灌篮少年	DEAR BOYS	DEAR BOYS,灌篮少年
.HACK  黄昏的腕轮传说		.HACK  黄昏の腕輪伝説
暗与帽子与书之旅人	ヤミと帽子と本の旅人	Yami_To_Bousi,ヤミと帽子と本の旅人,暗与帽子与
新撰组异闻录		PEACE MAKER铁,新撰组异闻录 铁,PEACE MAKER 鐵
京极夏彦 巷说百物语	京極夏彦 巷説百物語	京極夏彦 巷説百物語,巷说百物语
人鱼之森		人魚の森
战争程序员白濑		BPS バトルプログラマーシラセ
读或死 TV	R.O.D -THE TV-	R.O.D -THE TV-,READ OR DIE
读或死 OVA	R.O.D -READ OR DIE-	读或死,READ OR DIE
高桥留美子剧场		高橋留美子劇場
拜托了☆双子星		おねがい☆ツインズ,拜托了双子星
人生交叉点-HUMAN SCRAMBLE-		人間交差点,HUMAN SCRAMBLE
兽兵卫忍风帖		獣兵衛忍風帖,龍宝玉篇,龙宝玉篇
兽兵卫忍风帖		獣兵衛忍風帖,龍宝玉篇,龙宝玉篇
四圣兽 圣兽降临篇 2003		セイントビースト
四圣兽 几千个昼与夜 2005		セイントビースト
四圣兽 光阴叙事诗天使谭 2007		セイントビースト
成惠的世界		成恵の世界
钢铁守护者		GAD GUARD,ガドガード
魔法留学生		ウルトラマニアック,恋爱小魔女
妄想科学美少女		妄想科学シリーズ ワンダバスタイル,ワンダバスタイル
索尼克		音速小子,SONIC,SONIC THE HEDGEHOG,超音鼠,ソニックX
真月谭月姬	真月譚月姫	月姬,真月譚月姫,TSUKIHIME
机魂末世录		TEXHNOLYZE,テクノライズ
宇宙星路	宇宙のステルヴィア	宇宙のステルヴィア,宇宙的星路
变形金刚：微型传说		超ロボット生命体トランスフォーマー,微型金刚传说,マイクロン伝説
王室近卫队		L/R,LICENSED BY ROYAL
鼠辈怪盗		MOUSE,マウス,神偷盗鼠
高机动幻想～新结行军歌～		ガンパレード・マーチ〜新たなる行軍歌〜,高机动幻想,ガンパレード・マーチ
STRATOS 4		星空防卫队,ストラトス・フォー,星空少女队,彗星狙击战
明日的娜嘉		明日のナージャ,娜嘉寻亲记
神魂合体GODANNAR！！		神魂合体ゴーダンナー！！,神魂合体
铳墓	ガングレイヴ	铳墓,GUNGRAVE, ガングレイヴ,枪冢
百变之星	カレイドスター	カレイドスター,百变之星
星空清理者	プラネテス	プラネテス,ΠΛΑΝΗΤΕΣ,惑星奇航
爱的魔法	まぶらほ	爱的魔法,まぶらほ
圣枪修女	クロノクルセイド	圣枪修女,クロノクルセイド, CHRNO CRUSADE
夏娃的时间 剧场版	イヴの時間 劇場版	夏娃的时间,イヴの時間,Time of Eve
你所期望的永远		君が望む永遠,君望永远,愿此刻永恒,君望,Brain's Base
钟之音学院		グリーングリーン
变身侦探		
瓶装妖精		
萌娘商社		
天使怪盗		D・N・ANGEL
奇诺之旅	キノの旅 -the Beautiful World-	奇诺の旅,キノの旅,-the Beautiful World
最终流放	LAST EXILE	LAST EXILE,最后流亡
全金属狂潮	フルメタル・パニック!	Full Metal Panic!,フルメタルパニック!,全金属狂潮
全金属狂潮 校园篇	フルメタル・パニック? ふもっふ	フルメタル・パニック? ふもっふ,全金属狂潮 校园篇
全金属狂潮 The Second Raid	フルメタル・パニック! The Second Raid	Full Metal Panic!,フルメタルパニック!
青出于蓝	藍より青し	青出于蓝,藍より青し,未婚关系
青出于蓝～缘～	藍より青し～縁～	青出于蓝,藍より青し,未婚关系,藍より青し〜縁〜
返乡战士		帝皇战纪,OVERMAN キングゲイナー
寻找满月	満月をさがして	寻找满月,満月をさがして,星河满月
陆上防卫队		陸上防衛隊まおちゃん
鬼眼狂刀	サムライ ディーパー キョウ	鬼眼狂刀,サムライディーパーキョウ,Samurai Deeper Kyo
驭龙少年		ドラゴンドライブ
野狼前锋		ハングリーハー,野驁射手,WILD STRIKER,踢出我天地
魔女猎人罗宾	Witch Hunter ROBIN	WITCH HUNTER ROBIN,魔女猎人罗宾
最终兵器少女		最終兵器彼女
萩萩公主	プリンセスチュチュ	彩梦芭蕾,プリンセスチュチュ,PRINCESS TUTU,梦幻芭蕾
铁胆火车侠		
铁胆火车侠		電光超特急ヒカリアン
越狱兔 第1~5季		监狱兔,ウサビッチ,USAVICH
越狱兔 第0季		监狱兔,ウサビッチ,USAVICH
东京地下城	東京アンダーグラウンド	
.HACK SIGN		.HACK  时空
我们这一家 第一期		あたしンち
我们这一家 剧场版		あたしンち
东京猫猫	東京ミュウミュウ	東京ミュウミュウ,东京猫猫
天使的小生意气		天使な小生意気,鲁莽天使
阿倍野桥魔法☆商店街	アベノ橋魔法☆商店街	アベノ橋魔法☆商店街,阿倍野桥魔法☆商店街
水瓶新世纪		アクエリアンエイジ,水瓶战记
奇钢仙女楼兰		奇鋼仙女ロウラン
日常工作 第一季		REGULAR SHOW
日常工作 第二季		REGULAR SHOW
日常工作 第三季		REGULAR SHOW
日常工作 第四季		REGULAR SHOW
日常工作 第五季		REGULAR SHOW
日常工作 第六季		REGULAR SHOW
钢铁侦探J		ヒートガイジェイ
阿波特战记五九		猴王五九
钢琴恋曲		PIANO
天使特警 第一季		美女讨伐二人组,キディ・グレイド
天使特警 第二季		美女讨伐二人组,キディ・グレイド
人形电脑天使心	ちょびっツ	人形电脑,ちょびっツ,人形电脑天使心
欢乐课程		HAPPY★LESSON,欢乐教程
魔法咪路咪路		わがままフェアリーミルモでポン!,魔法小米路
拜托了☆老师	おねがい☆ティーチャー	おねがい☆ティーチャー,拜托了老师
推理之绊	スパイラル ～推理の絆～	推理の绊,スパイラル,螺旋~推理之绊
盗贼王Jing	王ドロボウJING	王ドロボウJING
闪灵二人组	GetBackers -奪還屋-	GETBACKERS奪還屋,闪灵二人组
灰羽联盟	灰羽連盟	灰羽联盟,灰羽連盟,Haibane Renmei
迷糊天使	ぴたテン	ぴたテン,迷糊天使,小夏钝帆
爆弹小新娘	りぜるまいん	爆弹小新娘,炸弹小新娘
圆盘皇女		円盤皇女ワるきゅーレ
炎之蜃气楼	炎の蜃気楼	炎の蜃気楼
翼神传说		ラーゼフォン,RAHXEPHON
真・女神转生 魔力宝贝		真・女神転生デビチル
真・女神转生 OVA		真・女神転生
白色猎人 第一季	ヴァイスクロイツ	白色猎人,ヴァイスクロイツ,Weiss Kreuz
白色猎人 第二季	ヴァイスクロイツ グリーエン	白色猎人,ヴァイスクロイツ,Weiss Kreuz,ヴァイスクロイツ グリーエン
DI GI CHARAT 第一季		超级偶像猫铃铛,铃铛猫娘,叮当小魔女,滴骰孖妹
DI GI CHARAT 超级铃铛猫Panyo Panyo(第二季）		ぱにょぱにょデ・ジ・キャラット
DI GI CHARAT DI GI CHARAT		超级偶像猫铃铛,铃铛猫娘,叮当小魔女,滴骰孖妹
战斗陀螺 第一季		爆転シュート ベイブレード
战斗陀螺 第二季		爆転シュート ベイブレード2002,陀螺战士 第二季
战斗陀螺 剧场版		爆転シュート ベイブレード
热带雨林的爆笑生活	ジャングルはいつもハレのちグゥ	爆笑热带雨林,ジャングルはいつもハレのちグゥ
热带雨林的爆笑生活 DELUXE	ジャングルはいつもハレのちグゥ デラックス	爆笑热带雨林,ジャングルはいつもハレのちグゥ,热带雨林的爆笑
热带雨林的爆笑生活 FINAL	ジャングルはいつもハレのちグゥ FINAL	爆笑热带雨林,ジャングルはいつもハレのちグゥ
天使的尾巴		天使のしっぽ
辣妹当家		超GALS!寿兰
七虹香电击大作战		ナジカ電撃作戦
X战记	X -エックス-	X,エックス,X战记
X战记 剧场版		X,エックス,X战记,X 剧场版
圣石小子		レイブ,RAVE
星之卡比		卡比,卡比之星,KIRBY,科比,星のカービィ
魔法少女猫		魔法少女猫たると
青春草莓蛋		あぃまぃみぃ!ストロベリー・エッグ,ストロベリー・エッグ,STRAWBERRY EGGS
超能奇兵		スクライド,分身战士
狂野禁区		Z.O.E DOLORES I,ゾーンオブエンダーズドロレス アイ
黑街二人组	NOIR	黑街二人组,NOIR
新白雪姬传说	新白雪姫伝説プリーティア	新白雪姫伝説プリーティア,新白雪姬传说
小小雪精灵		ちっちゃな雪使いシュガー
激斗战车		激闘!クラッシュギアTURBO
魔力女管家 第二季		まほろまてぃっく
魔力女管家 特别篇		まほろまてぃっく
天使领域	機動天使エンジェリックレイヤー	机动天使,機動天使エンジェリックレイヤー,天使领域
妹妹公主	シスター・プリンセス	シスタープリンセス,SISTER PRINCESS
妹妹公主 RePure	シスター・プリンセス RePure	シスター・プリンセス～リピュア～
漫画同人会 第一季		COMIC PARTY,こみっくパーティー,漫画派对
漫画同人会 OVA		COMIC PARTY,こみっくパーティー,漫画派对
漫画同人会 第二季		COMIC PARTY,こみっくパーティー,漫画派对
钢铁天使		鋼鉄天使くるみ,钢铁天使胡桃
钢铁天使2式		鋼鉄天使くるみ2式
足球小将 83版		
足球小将 平成版		キャプテン翼 平成版
巴比伦二世		バビル2世
巴比伦二世 2001版		バビル2世
袖珍女仆小梅		袖珍女仆,袖珍女侍小梅,袖珍女佣小梅
GEAR战士电童		GEAR戦士 電童
最游记	幻想魔伝 最遊記	SAIYUKI,基游记
最游记RELOAD		最遊記RELOAD
最游记 RELOAD GUNLOCK	最遊記RELOAD GUNLOCK	SAIYUKI,基游记
最游记外传		SAIYUKI,基游记
最游记RELOAD 埋葬篇	最遊記RELOAD -burial-	SAIYUKI,基游记
幻影死神		BOOGIEPOP PHANTOM
随风飘的月影兰		随风舞月影兰
梦幻妖子		妖しのセレス
我家也有外星人		NIEA_7
奇异的破晓		STRANGE DAWN
无敌王		无敌王TRIZENON
真女神转生 恶魔之子		真女神转生·恶魔之子
人造人间		人造人間キカイダー
万有引力	グラビテーション	万有引力,グラビテーション,Gravitation
X战警：进化		X战警：进化,Ｘ-ＭＥＮ：エボリューション
银河冒险战记 第一季		ヴァンドレッド
银河冒险战记 第二季		ヴァンドレッド
星界的战旗 星界的纹章		星界の戦旗
星界的战旗 TV版 星界的战旗I	星界の戦旗	星界の戦旗
星界的战旗TV版 星界的战旗II		星界の戦旗
星界的战旗 星界的战旗III		星界の戦旗
女神候补生	女神候補生	女神候补生
沉默的未知	アルジェントソーマ	沉默的未知,アルジェントソーマ
我为歌狂	我为歌狂	
最后的吸血鬼		
学校怪谈	学校の怪談	学校怪谈,学校の怪談
南方公园 第一季		SOUTHPARK
南方公园 第二季		SOUTHPARK
南方公园 第三季		SOUTHPARK
南方公园 第四季		SOUTHPARK
南方公园 第五季		SOUTHPARK
南方公园 第六季		SOUTHPARK
南方公园 第八季		SOUTHPARK
南方公园 第九季		SOUTHPARK
南方公园 第十季		SOUTHPARK
南方公园 第十二季		SOUTHPARK
南方公园 第十三季		SOUTHPARK
南方公园 第十四季		SOUTHPARK
南方公园 第十五季		SOUTHPARK
南方公园 第十六季		SOUTHPARK
南方公园 第十七季		SOUTHPARK
南方公园 第十八季		SOUTHPARK
恐怖宠物店	Petshop of Horrors	PETSHOP OF HORRORS,ペットショップ オブ ホラーズ
六翼天使之声		セラフィムコール,SERAPHIM CALL
傀儡师左近	人形草紙 あやつり左近	人形草紙あやつり左近,人形草纸,傀儡师左近
格斗小霸王		ジバクくん
虫孽	BLUE GENDER	BLUE GENDER,ブルージェンダー,虫孽
超级酷乐猫		霹雳酷乐猫,超级小黑咪
迷糊女战士		エクセルサーガ,EXCEL SAGA
此时此刻的我		今、そこにいる僕
地球防卫企业		地球防衛企業ダイガード,地球防御企业
无限的未知	無限のリヴァイアス	無限のリヴァイアス,无限的未知
封神演义 仙界传		封神演义,封神演義
机兽新世纪ZOIDS		ゾイド,ZOIDS,索斯机械兽
机兽新世纪ZOIDS		ゾイド,ZOIDS,索斯机械兽
A.D.特警		A.D.POLICE,アドバンスドポリス
魔装机神		魔装機神サイバスター
快感指令		KAIKANフレーズ,快感フレーズ
进化战记	ベターマン	ベターマン,BETTERMAN
平行世界物语		デュアル！ぱられルンルン物語
日本第一男人之魂		日本一の男の魂,日本第一的男人之魂
弹珠警察	Bビーダマン爆外伝V	BOM BOM弹珠人,弹珠人爆外传V,Bビーダマン爆外伝V,
微星小超人		小さな巨人ミクロマン
火魅子传		火魅子伝
THE BIG O		ＴＨＥビッグオー,魔神BIG O,魔神比古奥,魅影巨神
宇宙战舰山本洋子 TV版		それゆけ！宇宙戦艦ヤマモト・ヨーコ
宇宙战舰山本洋子 OVA		それゆけ！宇宙戦艦ヤマモト・ヨーコ
神风怪盗贞德	神風怪盗ジャンヌ	神風怪盗ジャンヌ,神风怪盗贞德
伊甸少年		エデンズ　ボゥイ
麻辣教师GTO	GTO	麻辣教师GTO,湘南纯爱组,湘南十四日,鬼冢英吉,G.T.O,ジーティーオー
如果在梦里遇见你		夢で逢えたら
钢铁新世纪		鉄コミュニケイション
快杰蒸汽侦探团		快傑蒸気探偵団
守护月天		まもって守護月天！
波波罗古洛伊斯物语		ポポロクロイス物語,POPOLOCROIS
饿沙罗鬼		ガサラキ
危险调查员		マスターキートン
影技		SHADOW SKILL～影技～,SHADOW SKILL
玲音	Serial Experiments Lain	シリアルエクスペリメンツ・レイン,SERIAL EXPERIMENTS LAIN
女棒甲子园		プリンセスナイン,如月女子高野球部,PRINCESS NINE
南海奇皇		ネオランガ,NEO RANGA
失落的宇宙		ロストユニバース,LOST UNIVERSE,失落宇宙
魔法阵都市 TV版		サイレントメビウス,SILENT MÖBIUS
秋叶原电脑组	アキハバラ電脳組	秋叶原电脑组
青涩宝贝		センチメンタルジャーニー,青涩之恋
婆娑罗		LEGEND OF BASARA,レジェンドオブバサラ
灵魂力量		ブレンパワード
梦幻拉拉	魔法のステージファンシーララ	魔法小美穗
星际牛仔	カウボーイビバップ	COWBOY BEBOP
弹珠人爆外传		Bビーダマン爆外伝,ボンバーマンビーダマン,炸弹人 弹珠人爆外传
万能文化猫娘 TV版		万猫
万能文化猫娘 OVA		万猫
星方武侠		星方武侠アウトロースター
魔术士奥芬 第一季		魔術士オーフェン
魔术士奥芬 第二季		魔術士オーフェン
魔卡少女樱		木之本樱,百变小樱,百变小樱魔术卡,初代萌王,カードキャプターさくら
四驱兄弟		四驱赛车,爆走兄弟レッツ＆ゴー!!
四驱兄弟WGP		四驱赛车,爆走兄弟レッツ＆ゴー!!
EAT-MAN		螺丝侠
少女革命	少女革命ウテナ	
甜心战士F	キューティーハニーF	キューティーハニーF
甜心战士		CUITE HONEY,キューティーハニー
灵异猎人		HAUNTEDじゃんくしょん
CLAMP学园侦探团	CLAMP学園探偵団	CLAMP大妈侦探团,CLAMP学园侦探团
晴天小猪		晴天
烈火之炎	烈火の炎	烈火の炎,烈火之炎
NEXT战记EHRGEIZ		ネクスト戦記EHRGEIZ
大运动会		バトルアスリーテス
杀人科 excess		BURN-UP,バーンナップ,BURN-UP EXCESS,BURN-UP SCRAMBLE
杀人科 W		BURN-UP,バーンナップ,BURN-UP EXCESS,BURN-UP SCRAMBLE
樱花大战 TV版	サクラ大戦TV	
樱花大战 OVA1 樱华绚烂	サクラ大戦 桜華絢爛	樱花大战,樱华绚烂,サクラ大戦 桜華絢爛
机动战舰大和抚子 TV版	機動戦艦ナデシコ	机动战舰抚子,机动战舰,机动战舰NADESICO,機動戦艦ナデシコ
奥运高手		ガンバリスト！駿
佐罗的传说		怪傑ゾロ,飞侠佐罗,怪杰佐罗
钢铁神兵		B'T-X
VS骑士弹珠汽水&40炎	VS騎士ラムネ＆40炎	VS騎士ラムネ＆40炎
乌龙派出所		こちら葛飾区亀有公園前派出所
天空之艾斯嘉科尼		圣天空战记,天空のエスカフローネ
勇者指令 TV版		勇者指令ダグオン
勇者指令 OVA		勇者指令ダグオン
浪客剑心	るろうに剣心 -明治剣客浪漫譚-	浪客剑心,るろうに剣心,明治剣客浪漫譚
YAT安心！宇宙旅行		星际漫游YAYAYA,YAT安心！宇宙旅行
玩偶游戏		こどものおもちゃ
海尔兄弟		
街头霸王2 V	ストリートファイターII V	街霸,STREET FIGHTER,ストリートファイター,街头霸王2 V
街头霸王 剧场版		街霸,STREET FIGHTER,ストリートファイター,街头霸王2 V
十二生肖守护神		十二戦支 爆烈エトレンジャー
宇宙小毛球		モジャ公
神秘的世界		神秘世界,神秘の世界エルハザード,神秘世界EL HAZARD
爆走猎人	爆れつハンター	爆れつハンター,爆走猎人
近所物语	ご近所物語	ご近所物語,芳邻物语,芳邻同盟会,近所物语
H2		好逑双物语
黄金勇者		黄金勇者ゴルドラン
鬼神童子ZENKI		鬼神童子
不思议游戏	ふしぎ遊戯	不可思议的游戏,梦幻游戏,魔幻游戏,ふしぎ遊戯
怪盗圣少女	怪盗セイント・テール	圣少女,怪盗セイントテール,怪盗圣少女
婚纱小天使		爱天使传说,愛天使伝説ウェディングピーチ
橘子酱男孩	ママレード・ボーイ	橘子酱男孩,ママレードボーイ
魔法骑士		魔法骑士レイアース
咕噜咕噜魔法阵		魔法陣グルグル,咕噜咕噜魔法阵 心跳传说,心跳传说
机动警察		
足球风云		蒼き伝説シュート！
疾风战士		疾風！アイアンリーガー
热血最强哥修罗		热血最强,熱血最強ゴウザウラー
勇者特急		勇者特急マイトガイン
无责任舰长		無責任艦長タイラー
九龙珠		剑勇传说
叮当猫		ポコニャン！
蜡笔小新		クレヨンしんちゃん,CRAYON SHIN-CHAN
幽游白书	幽☆遊☆白書	幽☆遊☆白書,幽游白书
俏皮小花仙		花の魔法使いマリーベル
勇者传说		伝説の勇者ダ・ガーン
元气爆发		元気爆発ガンバルガー
饿狼传说		バトルファイターズ餓狼伝説
哆啦A梦 剧场版		机器猫,ドラえもん,哆啦A梦 剧场版,哆啦A梦
动画秘密花园		アニメ ひみつの花園
青兰圆舞曲		おにいさまへ…
横山光辉三国志		横山光輝 三国志
狡猾飞天德		怪鸭历险记
天命神童		
高智能方程式		
御宅族的錄影帶		おたくのビデオ
盖塔机器人 TV版		ゲッターロボ
盖塔机器人 真盖塔		ゲッターロボ
盖塔机器人 新盖塔		ゲッターロボ
魔神英雄传		魔神英雄伝ワタル,神龙斗士
魔神英雄传		魔神英雄伝ワタル2
蓝宝石之谜 TV版		ふしぎの海のナディア,冒险少女娜汀亚,海底两万里,THE SECRET OF BLUE WATER,不可思议之海的娜汀亚
三眼神童 TV版	三つ目がとおる	三眼小子,三眼童子,三つ目がとおる
三眼神童OVA 恶魔岛的王子	悪魔島のプリンス 三つ目がとおる	三眼小子,三眼童子,三つ目がとおる,恶魔岛的王子 三眼神童
辛普森一家 第一季		THE SIMPSONS
辛普森一家 第三季		THE SIMPSONS
辛普森一家 第四季		THE SIMPSONS
辛普森一家 第五季		THE SIMPSONS
辛普森一家 第六季		THE SIMPSONS
辛普森一家 第七季		THE SIMPSONS
辛普森一家 第八季		THE SIMPSONS
辛普森一家 第九季		THE SIMPSONS
辛普森一家 第十季		THE SIMPSONS
辛普森一家 第十一季		THE SIMPSONS
辛普森一家 第十二季		THE SIMPSONS
辛普森一家 第十三季		THE SIMPSONS
辛普森一家 第十四季		THE SIMPSONS
辛普森一家 第十五季		THE SIMPSONS
辛普森一家 第十六季		THE SIMPSONS
辛普森一家 第十七季		THE SIMPSONS
辛普森一家 第十八季		THE SIMPSONS
辛普森一家 第十九季		THE SIMPSONS
辛普森一家 第二十一季		THE SIMPSONS
辛普森一家 第二十二季		THE SIMPSONS
辛普森一家 第二十三季		THE SIMPSONS
辛普森一家 第二十四季		THE SIMPSONS
辛普森一家 第二十五季		THE SIMPSONS
辛普森一家 第二十六季		THE SIMPSONS
五星物语	ファイブスター物語	五星物语,ファイブスター物語
猫怪麦克		
天空战记		天空戦記シュラト
柔道少女		YAWARA!
四驱小子	ダッシュ!四駆郎	四驱小子
乱马1/2 TV版	らんま1/2	らんま,RANMA,乱马
乱马1/2 OVA	らんま1/2	らんま,RANMA,乱马
光能使者		魔动王グランゾート,魔动王
魔神坛斗士		鎧伝サムライトルーパー
超音战士 TV版		超音戦士ボーグマン
铁拳小子		鉄拳チンミ
森林好小子	燃える! お兄さん	森林好小子,卡內奇
银河英雄传说 白银之谷		莱茵哈特,银英,銀河英雄伝説
银河英雄传说 叛乱者		莱茵哈特,银英,銀河英雄伝説
银河英雄传说 决斗者		莱茵哈特,银英,銀河英雄伝説
银河英雄传说 夺还者		莱茵哈特,银英,銀河英雄伝説
银河英雄传说 朝之梦、夜之歌		莱茵哈特,银英,銀河英雄伝説
银河英雄传说 污名		莱茵哈特,银英,銀河英雄伝説
银河英雄传说 螺旋迷宫		莱茵哈特,银英,銀河英雄伝説
妙手小厨师		ミスター味っ子
三个火枪手 TV版		アニメ三銃士
超能力魔美 TV版		エスパー魔美,超少女魔美,魔美一点灵
机甲战记威龙		機甲戦記ドラグナー
城市猎人 SP		シティーハンター
城市猎人 TV版		シティーハンター
王立宇宙军		
橙路 TV版		きまぐれオレンジ☆ロード
苍之流星SPT雷兹纳		苍之流星雷兹纳,蒼き流星SPTレイズナー,苍之流星
忍者战士飞影		忍者戦士飛影
搞怪拍档		银河女警花,ダーティペア,DIRTY PAIR
超兽机神断空我		超獣機神ダンクーガ
棒球英豪 TV版		邻家女孩,棒球小子,TOUCH,TATCHI,タッチ
棒球英豪 剧场版		邻家女孩,棒球小子,TOUCH,TATCHI,タッチ
超时空骑团		超時空騎団サザンクロス
小小外星人	とんがり帽子のメモル	とんがり帽子のメモル
机甲界		機甲界ガリアン
机甲创世记		機甲創世記モスピーダ
圣战士丹拜因		聖戦士ダンバイン
银河疾风		銀河疾風サスライガー
超时空世纪ORGUSS		超時空世紀オーガス
装甲骑兵VOTOMS		VOTOMS,装甲骑兵ボトムズ,装甲骑兵波多姆斯
银河漂流VIFAM		銀河漂流バイファム
太阳之牙		太陽の牙ダグラム
机甲舰队达莱卡XV		機甲艦隊ダイラガーXV
银河烈风		銀河烈風バクシンガー
心跳今夜		ときめきトゥナイト
重战机		重戦機エルガイム
六神合体		
福星小子 TV版		うる星やつら
福星小子 OVA		うる星やつら
尼尔斯骑鹅旅行记		ニルスのふしぎな旅
传说巨神伊迪安		伝説巨神イデオン
铁臂阿童木 80版		ASTRO BOY,鉄腕アトム
铁臂阿童木 03版		ASTRO BOY,鉄腕アトム
宇宙战舰大和号 第一季		宇宙战舰大和号2199,宇宙戦艦ヤマト
宇宙战舰大和号 第二季		宇宙戦艦ヤマト2
宇宙战舰大和号 第三季		宇宙战舰大和号2199,宇宙戦艦ヤマト
宇宙战舰大和号 2199		宇宙战舰大和号2199,宇宙戦艦ヤマト
宇宙战舰大和号 剧场版		宇宙战舰大和号2199,宇宙戦艦ヤマト
哆啦A梦 大山版		机器猫,ドラえもん
哆啦A梦 春之章		机器猫,ドラえもん
凡尔赛玫瑰		ベルサイユのばら
红发安妮		红头发安妮,红发少女安妮,绿山墙的安妮
宇宙魔神大剑豪		宇宙魔神ダイケンゴー
无敌钢人泰坦3		無敵鋼人ダイターン3
斗将戴莫斯 TV版		斗将大武士,闘将ダイモス
未来少年柯南		未来少年コナン
超人战队BARATTACK		超人戦隊バラタック
超合体魔术机器人 GINGUISER		超合体魔术机械,超合体魔術ロボ ギンガイザー
超电磁侠波鲁吉斯V		V型电磁侠,超電磁マシーン ボルテスV
合身战队机器人MECHANDER		合身战队麦康达机器人
鲁邦三世 第一季		ルパン三世,LUPIN THE THIRD,雷朋三世
鲁邦三世 第二季		山田康雄,小林清志,增山江威子,井上真树夫,纳谷悟朗
鲁邦三世 第三季		ルパン三世,LUPIN THE THIRD,雷朋三世
鲁邦三世 剧场版		ルパン三世,LUPIN THE THIRD,雷朋三世
无敌龙卷风		マグネロボ ガ・キーン
超电磁机器人恐・巴特拉V		超電磁ロボ コン・バトラーＶ,超电磁侠孔巴特拉V
钢铁杰克 TV版		鋼鉄ジーグ,钢铁吉克
钢铁杰克 剧场版		鋼鉄ジーグ,钢铁吉克
聪明的一休		一休さん
宇宙骑士铁甲人		宇宙骑士铁铠人,宇宙の騎士テッカマン
大魔神		グレートマジンガー,大魔神GREAT MAZINGER
阿尔卑斯山的少女	アルプスの少女ハイジ	アルプスの少女ハイジ,阿尔卑斯山的少女
ChargeMan研！		東方充電男,チャージマン研!,CHA研,东方充电男,CHARGEMAN研,チャージマン研！
铁甲飞天侠		アストロガンガー
恶魔人	デビルマン	恶魔人,デビルマン
恶魔人 OVA		恶魔人,デビルマン
明日之丈		あしたのジョー
海螺小姐		
鼹鼠的故事		
街头霸王 OVA		街霸,STREET FIGHTER,ストリートファイター,街头霸王2 V
福星小子 剧场版		うる星やつら
福星小子 完结篇		うる星やつら
失落的宇宙 黑历史		ロストユニバース,LOST UNIVERSE,失落宇宙
少女革命剧场版 思春期默示录	少女革命ウテナ アドゥレセンス黙示録	
三个火枪手 剧场版		アニメ三銃士
超能力魔美 剧场版		エスパー魔美,超少女魔美,魔美一点灵
城市猎人 剧场版		シティーハンター
不思议游戏 OVA1 后篇	オリジナルビデオシリーズ ふしぎ遊戯	不可思议的游戏,梦幻游戏,魔幻游戏,ふしぎ遊戯
不思议游戏 永光传	ふしぎ遊戯 永光伝	不可思议的游戏,梦幻游戏,魔幻游戏,ふしぎ遊戯
斗将戴莫斯 剧场版		斗将大武士,闘将ダイモス
魔法阵都市 剧场版		サイレントメビウス,SILENT MÖBIUS
乱马1/2 剧场版		らんま,RANMA,乱马
超音战士 OVA		超音戦士ボーグマン
超音战士 新世纪2058		超音戦士ボーグマン
橙路 OVA		きまぐれオレンジ☆ロード
橙路 剧场版		きまぐれオレンジ☆ロード
相聚一刻 剧场版		
机动战舰大和抚子 OVA	機動戦艦ナデシコ	机动战舰抚子,机动战舰,机动战舰NADESICO,機動戦艦ナデシコ
机动战舰大和抚子 剧场版	機動戦艦ナデシコ -The prince of darkness-	机动战舰抚子,机动战舰,机动战舰NADESICO,機動戦艦ナデシコ
中华小当家	中華一番！	中华小当家,中華一番！
葫芦兄弟		葫芦娃,葫芦小金刚
三毛流浪记		
阿凡提的故事		
邋遢大王奇遇记		小邋遢
黑猫警长		
舒克和贝塔		
葫芦小金刚		葫芦娃,葫芦小金刚
镜花缘		
魔方大厦		
自古英雄出少年		ZIGUYINGXIO
BRAVO东东		
封神榜传奇		
白鸽岛		
隋唐英雄传 动画版		
西游记 央视动画		
哪吒传奇		
最强武将传·三国演义		ZUIQIANGWUJI
小蝌蚪找妈妈		
没头脑和不高兴		
哪吒闹海		
天书奇谭		
宝莲灯		
新版大闹天宫		
九色鹿		
魔法少女小圆	魔法少女まどか☆マギカ	魔法少女まどか☆マギカ
灰体		THEGRAY
Punch Line	パンチライン	パンチライン,Punch Line,妙语
勇者大冒险		
狐妖小红娘		狐妖小红娘,狐狸精调教手册
星之声	ほしのこえ	星辰细语,ほしのこえ,THE VOICES OF A DISTANT STAR
云之彼端，约定的地方	雲のむこう、約束の場所	云之彼端,约定的场所,雲のむこう、約束の場所
言叶之庭	言の葉の庭	言语之庭,言叶之庭,言の葉の庭
小魔女学园		LITTLEWITCHACADEMIA,リトル ウィッチ アカデミア
哆啦A梦 大雄的恐龙		大雄的恐龙,のび太の恐竜,大雄的小恐龙
哆啦A梦 大雄的宇宙开拓史		大雄的宇宙开拓史,のびたの宇宙開拓史
哆啦A梦 大雄的大魔境		大雄的大魔境,のび太の大魔境
哆啦A梦 大雄的海底鬼岩城		大雄的海底鬼岩城,のび太の海底鬼岩城
哆啦A梦 大雄的宇宙小战争		大雄的宇宙小战争,のび太の宇宙小戦争
哆啦A梦 大雄与铁人兵团		大雄与铁人兵团,のび太と鉄人兵団
哆啦A梦 大雄与龙骑士		大雄与龙骑士,のび太と竜の騎士,大雄与龙之骑士
哆啦A梦 大雄的平行西游记		大雄的平行西游记,のび太のパラレル西遊記
哆啦A梦 大雄与日本诞生		大雄与日本诞生,のび太の日本誕生
哆啦A梦 大雄与动物行星		大雄与动物行星,のび太とアニマル惑星,大雄与惑星之谜,惑星之谜
哆啦A梦 大雄的天方夜谭		大雄的天方夜谭,のび太のドラビアンナイト
哆啦A梦 大雄与云之王国		大雄与云之王国,のび太と雲の王国,大雄的云之国
哆啦A梦 大雄和白金迷宫		大雄和白金迷宫,のび太とブリキの迷宮
哆啦A梦 大雄与梦幻三剑士		大雄与梦幻三剑士,のび太と夢幻三剣士
哆啦A梦 大雄的创世日记		大雄的创世日记,のび太の創世日記
哆啦A梦 大雄与银河超特急		大雄与银河超特急,のび太と銀河超特急,大雄和银河超特快列车
哆啦A梦 大雄的南海大冒险		大雄的南海大冒险,のび太の南海大冒険
哆啦A梦 大雄的太阳王传说		大雄的太阳王传说,のび太の太陽王伝説
哆啦A梦 大雄与风之使者		大雄与风之使者,のび太とふしぎ風使い,大雄与不可思议的风使者
哆啦A梦 大雄的猫狗时空传		大雄的猫狗时空传,のび太のワンニャン時空伝
幸腹涂鸦	幸腹グラフィティ	幸腹グラフィティ
Chaos Dragon 赤龙战役	ケイオスドラゴン 赤竜戦役	混沌之龙,赤龙战役,Chaos Dragon 赤龙战役
Charlotte	シャーロット	夏洛特,シャーロット
魔法少女☆伊莉雅	Fate/kaleid liner プリズマ☆イリヤ	FATE/KALEID LINER,魔法少女伊莉雅,魔法少女伊利亚,fate
魔法少女☆伊莉雅 2WEI!	Fate/kaleid liner プリズマ☆イリヤ ツヴァイ!	プリズマ☆イリヤ 2WEI！(第2期),魔法少女☆伊莉雅 2WEI,魔法少女☆伊莉雅 第二季
魔法少女☆伊莉雅 2WEI HERZ!	Fate/kaleid liner プリズマ☆イリヤ ツヴァイヘルツ!	魔法少女☆伊莉雅第三期,魔法少女☆伊莉雅 2wei Herz!
OVERLORD	オーバーロード	オーバーロード,OVER LORD,不死者之王
百万偶像	ミリオンドール	Million Doll,百万偶像,ミリオンドール
赤发白雪姬 第一季	赤髪の白雪姫	赤发白雪姬,赤髪の白雪姫,红发的白雪公主
创圣的大天使LOGOS	アクエリオンロゴス	アクエリオンロゴス
干物妹！小埋	干物妹!うまるちゃん	干物妹小埋,小埋,干物妹!うまるちゃん
黑塔利亚 The World Twinkle 第6期	ヘタリア The World Twinkle	黑塔利亚,HETALIA,ヘタリア,APH
Classroom☆Crisis	Classroom☆Crisis	クラスルーム☆クライシス,教室☆危机,教室危机
空战魔导士候补生的教官	空戦魔導士候補生の教官	空战魔导士候补生的教官,空戦魔導士候補生の教官
六花的勇者	六花の勇者	六花的勇者,六花の勇者
乱步奇谭 Game of Laplace	乱歩奇譚 Game of Laplace	乱歩奇譚 GAME OF LAPLACE,乱步奇谭
迷糊餐厅 WORKING!!!	WORKING!!!	WORKING!!! (第3期)
那就是声优！	それが声優！	那就是声优！,それが声優！
青春×机关枪	青春×機関銃	青春×机关枪,青春×機関銃,青春机关枪,BrainsBase
若叶女孩		若葉女孩,わかば＊ガール,若叶少女
噬神者	ゴッドイーター	噬神者,GE,GOD EATER ,ゴッドイーター
学园孤岛	がっこうぐらし!	学园孤岛,がっこうぐらし!
洲崎西 THE ANIMATION	洲崎西 THE ANIMATION	洲崎西,洲崎西 THE ANIMATION
偶像大师 灰姑娘女孩 第2期	アイドルマスター シンデレラガールズ 2ndシーズン	アイドルマスター シンデレラガールズ,偶像大师灰姑娘女孩
无头骑士异闻录 x2 转	デュラララ!!×2 転,	无头骑士异闻录,デュラララ,无头骑士异闻录 x2 转
英雄别闹		HEROESDON’T BIBI
东京教父	東京ゴッドファーザーズ	TOKYO GODFATHERS,东京ゴッドファーザーズ,东
新网球王子 OVA 对战Genius10	新テニスの王子様 OVA vs Genius10	テニスの王子様,新网球王子
VENUS PROJECT -CLIMAX-	ヴィーナスプロジェクト	VENUS PROJECT,维纳斯计划
我老婆是学生会长！	おくさまが生徒会長!	おくさまが生徒会長！
GANGSTA.	GANGSTA.	GANGSTA,黑街,GANGSTA黑街
和歌子酒 动画	ワカコ酒	
龙珠超		龙珠SUPER
网球并不可笑嘛 第五季	てーきゅう 5期	网球少女 第五季,女高网球部 第五季,てーきゅう 5期
怪兽酒场干杯！	怪獣酒場カンパーイ！	怪兽酒场干杯
比基尼勇士	BIKINI WARRIORS	比基尼勇士,ビキニ・ウォリアーズ,BIKINI WARRIORS
枕男子	枕男子	
魔物娘的同居日常（台港澳）		モンスター娘のいる日常,魔物娘的同居日常
群居姐妹	だんちがい	だんちがい
兔宝的悲惨日常 梦幻篇	うーさーのその日暮らし 夢幻編	兔宝的悲惨日常 梦幻篇,兔宝的悲惨日常 梦幻篇（第三季）
黑白小姐 第一季	ミス・モノクローム -The Animation-	ミス・モノクローム
黑白小姐 第二季	ミス・モノクローム -The Animation- 2	ミス・モノクローム 第2期
Gate 奇幻异世界		Gate 奇幻异世界,彼の地にて、斯く戦えり
潮与虎		うしおととら
監獄學園（台港澳）		監獄学園プリズンスクール,监狱学园,監獄学園
茄子·安达卢西亚之夏		NASU SUMMER,茄子 アンダルシアの夏
魔物娘的相伴日常	モンスター娘のいる日常	
绅士学园		绅士学园
纯情罗曼史3	純情ロマンチカ3	
純情羅曼史 第3季（台港澳）		純情羅曼史 第3季
疯狂时代		
端脑		
雏蜂 中文版		
游戏王 重制版 决斗者王国篇		20周年的重制版,游戏王DM
游戏王 重制版 战斗都市篇		20周年的重制版,游戏王DM
Robot Girls Z 第一季		
Robot Girls Z PLUS（第二季）		
未来卡 搭档对战 100（第二季） 第一期		フューチャーカード バディファイト100
混沌白书		
择天记 正片		
择天记 Q版小剧场		
口水三国		糖水三国
虫师 续章 铃之雫	蟲師 特別編 鈴の雫	むしし,MUSHISHI
我叫白小飞		我叫白小飞
We Bare Bears 咱们裸熊 第一季		WE BARE BEARS,咱们裸熊
瑞克和莫蒂 第一季	Rick and Morty Season 1	
瑞克和莫蒂		
怪化猫	モノノ怪	怪化猫,モノノ怪,MONONOKE
CLANNAD 另一个世界 智代篇	CLANNAD もうひとつの世界 智代編	
绝对防卫利维坦	絶対防衛レヴィアタン	绝对防卫利维坦,絶対防衛レヴィアタン
雏蜂 日语版		
植木的法则	うえきの法則	うえきの法则  LAW OF UEKI,植木的法则
我的妹妹不可能那么可爱 第一季	俺の妹がこんなに可愛いわけがない	俺妹,俺の妹がこんなに可爱いわけがない,我的妹妹哪有这么可爱
我的妹妹不可能那么可爱 第二季	俺の妹がこんなに可愛いわけがない。	俺妹,俺の妹がこんなに可爱いわけがない,我的妹妹哪有这么可爱
星球流浪记	無人惑星サヴァイヴ	無人惑星サヴァイヴ,星球流浪记
飞跃巅峰 第一季		GUNBUSTER,飞越巅峰,トップをねらえ!,钢巴斯塔,AIM FOR THE TOP GUNBUSTER
回忆三部曲 Memories		メモリーズ
飞跃巅峰 第二季		GUNBUSTER,飞越巅峰,トップをねらえ!,钢巴斯塔,AIM FOR THE TOP GUNBUSTER
比基尼勇士（台港澳）		
我女友与青梅竹马的惨烈修罗场	俺の彼女と幼なじみが修羅場すぎる	我的后宫修罗场,俺修罗,我修罗,夹在我女友和青梅竹马之间的各种修罗场
小马宝莉 第一季	My Little Pony: Friendship Is Magic (Season 1)	彩虹小马,萌马,我的小马驹,彩虹小马：友谊是魔法,我的小马驹：友谊的魔力,小马宝莉：友谊的魔力,MLP,MY LITTLE PONY,FRIENDSHIP IS MAGIC,G4,MLP:FIM
小马宝莉 第二季	My Little Pony: Friendship Is Magic : S2	彩虹小马,萌马,我的小马驹,彩虹小马：友谊是魔法,我的小马驹：友谊的魔力,小马宝莉：友谊的魔力,MLP,MY LITTLE PONY,FRIENDSHIP IS MAGIC,G4,MLP:FIM
小马宝莉 第三季	My Little Pony: Friendship Is Magic S3	彩虹小马,萌马,我的小马驹,彩虹小马：友谊是魔法,我的小马驹：友谊的魔力,小马宝莉：友谊的魔力,MLP,MY LITTLE PONY,FRIENDSHIP IS MAGIC,G4,MLP:FIM
小马宝莉 第四季	My Little Pony: Friendship Is Magic : S4	彩虹小马,萌马,我的小马驹,彩虹小马：友谊是魔法,我的小马驹：友谊的魔力,小马宝莉：友谊的魔力,MLP,MY LITTLE PONY,FRIENDSHIP IS MAGIC,G4,MLP:FIM
小马宝莉 第五季	My Little Pony: Friendship Is Magic : S5	彩虹小马,萌马,我的小马驹,彩虹小马：友谊是魔法,我的小马驹：友谊的魔力,小马宝莉：友谊的魔力,MLP,MY LITTLE PONY,FRIENDSHIP IS MAGIC,G4,MLP:FIM
我的脑内选项正在全力妨碍学园恋爱喜剧	俺の脳内選択肢が、学園ラブコメを全力で邪魔している	我的脑内恋碍选项,俺の脳内選択肢
东之伊甸	東のエデン	東のエデン,Eden of the East,东のエデン
东之伊甸 剧场版	東のエデン 劇場版	東のエデン,Eden of the East,东のエデン,东之伊甸 剧场版 失乐园,东之伊甸 剧场版 伊甸之王
境界线上的地平线  第一季	境界線上のホライゾン	境界线上のホライゾン
境界线上的地平线  第二季	境界線上のホライゾンII	境界线上のホライゾン
轮回的拉格朗日 第一季		轮廻のラグランジェ-轮回的lagrange,轮廻のラグランジェ,轮回的LAGRANGE
轮回的拉格朗日 第二季		轮廻のラグランジェ-轮回的lagrange,轮廻のラグランジェ,轮回的LAGRANGE
男子高中生的日常	男子高校生の日常	男子高校生的日常,男子高校生の日常,男子高中生の日常,男高
男子高中生的日常 SP	男子高校生の日常 特典映像	男子高校生的日常,男子高校生の日常,男子高中生の日常
萝球社！	ロウきゅーぶ！	ロウきゅーぶ!,萝球社SS,萝球社
萝球社！SS	ロウきゅーぶ！SS	ロウきゅーぶ！SS,萝球社！SS
偶像大师	THE iDOLM@STER	IDOLM@STER,IDOLMASTER,偶像大师
偶像大师 剧场版 向着光辉的彼岸！	THE IDOLM@STER MOVIE 輝きの向こう側へ！	IDOLM@STER,IDOLMASTER,偶像大师 剧场版 向着光辉的彼岸
穿越时空的少女	時をかける少女	跳跃吧！时空少女,我在未来等你,時をかける少女
秒速五厘米	秒速5センチメートル	秒速5厘米,秒速5センチメートル
双面骑士		CHEVALIER,女装骑士
我叫MT 第一季		哀木涕,I\\'M MT
我叫MT 第二季		哀木涕,I\\'M MT
我叫MT 第三季		哀木涕,I\\'M MT
我叫MT 第四季		哀木涕,I\\'M MT
我叫MT 第五季		哀木涕,I\\'M MT
我叫MT 第六季		哀木涕,I\\'M MT
野良耳		のらみみ
超级肥皂		SUPER SOAP
银河机攻队MAJESTIC PRINCE		银河机攻战队,银河机攻队,銀河機攻隊マジェスティックプリンス,银河机攻战队MAJESTIC PRINCE
战斗妖精雪风	戦闘妖精雪風	戦闘妖精雪風
圣母在上 ~春~	マリア様がみてる 〜春〜	圣母在上,マリア様がみてる,玛莉亚的凝望
圣母在上 第三季	マリア様がみてる 3rdシーズン	圣母在上,マリア様がみてる,玛莉亚的凝望
圣母在上 第四季	マリア様がみてる 4thシーズン	圣母在上,マリア様がみてる,玛莉亚的凝望
黑塔利亚 Axis Powers	ヘタリア Axis Powers	黑塔利亚,HETALIA,ヘタリア,APH
丙级超人快递侠		
山口山战记 草裙娃娃		我叫MT 第7季
黑塔利亚 World Series 第3期	ヘタリア World Series 第3期	HETALIA,APH
黑塔利亚 The Beautiful World 第5期	ヘタリア The Beautiful World	黑塔利亚,HETALIA,ヘタリア,APH
有你的小镇	君のいる町	君のいる町,小镇有你
女神异闻录4	ペルソナ4	ペルソナ4,PERSONA4,P4,女神异闻录4
DIABOLIK LOVERS MORE,BLOOD		魔鬼恋人第二季,魔鬼爱人 第二季,魔鬼恋人 MORE，BLOOD,DIABOLIK LOVERS MORE，BLOOD,魔鬼恋人 MORE BLOOD,DIABOLIK LOVERS MORE BLO
枪与假面舞会	ランス・アンド・マスクス	枪与假面舞会,LANCEN MASQUES,ランス・アンド・マスクス
青年黑杰克	ヤング ブラック・ジャック	青年黑杰克,ヤング ブラック・ジャック
骇客娃娃	ハッカドール THE・あにめ～しょん	骇客娃娃,ハッカドール THE・あにめ～しょん,HACKA DOLL
学战都市Asterisk	学戦都市アスタリスク	学战都市Asterisk,学戦都市アスタリスク,学战都市 六芒星
对魔导学园35试验小队	対魔導学園35試験小隊	对魔导学园35试验小队,対魔導学園35試験小隊,AntiMagic Academy 35th Test Platoon
K RETURN OF KINGS	K RETURN OF KINGS	K 回归的王权者,K 第二季,K RETURN OF KINGS
全部成为F -THE PERFECT INSIDER-	すべてがFになる THE PERFECT INSIDER	全部成为F,すべてがFになる
温泉幼精箱根酱	温泉幼精ハコネちゃん	温泉幼精ハコネちゃん,温泉幼精小箱根
我被绑架到贵族女校当庶民样本	俺がお嬢様学校に「庶民サンプル」としてゲッツされた件	庶民标本,庶民样本,关于我被绑架到大小姐学校当庶民样本,俺がお嬢様学校に「庶民サンプル」としてゲッツ♥された件,关于我被绑架到大小姐学校当庶民样本这件事,关于我被绑架到大小姐学校当「庶民样本」这件事
野良神 ARAGOTO	ノラガミ ARAGOTO	野良神,野良神 第二季,ノラガミ ARAGOTO
不思议美眉	不思議なソメラちゃん	不思議なソメラちゃん,不思议美眉
高校星歌剧	スタミュ	高校星歌剧,ハイスクールスター・ミュージカル,スタミュ
侦探小队KZ事件簿	探偵チームKZ事件ノート	探偵チームKZ事件ノート
重装武器	ヘヴィーオブジェクト	重装武器,HEAVY OBJECT,ヘヴィーオブジェクト
Concrete Revolutio 超人幻想 第一季	コンクリート・レボルティオ～超人幻想～	コンクリート・レボルティオ～超人幻想～, Concrete Revolutio 超人幻想,CONCRETEREVOLUTIO 超人幻想
樱子小姐的脚下埋着尸体	櫻子さんの足下には死体が埋まっている	樱子小姐的脚下埋着尸体,櫻子さんの足下には死体が埋まっている,樱子小姐
落第骑士英雄谭		落第骑士,落第騎士の英雄譚
小森同学拒绝不了！	小森さんは断れない！	小森さんは断れない！,小森同学拒绝不了！
彗星路西法	コメット・ルシファー	彗星路西法,コメット・ルシファー,Comet Lucifer
Dance with Devils	Dance with Devils	与魔共舞,BrainsBase
终物语	終物語	终物语,終物語
终结的炽天使 名古屋决战篇	終わりのセラフ 名古屋決戦編	终结的炽天使,終わりのセラフ,名古屋决战篇
传颂之物 虚伪的假面	うたわれるもの 偽りの仮面	传颂之物,うたわれるもの,传颂之物 虚伪的假面
请问您今天要来点兔子吗？？	ご注文はうさぎですか？？	ご注文はうさぎですか？？,请问您今天要来点兔子吗？？,点兔,点兔 第二季
雨色可可 欢迎来到RAINY COLOR！	雨色ココア Rainy colorへようこそ！	雨色可可,雨色ココア,雨色可可 欢迎来到RAINY COLOR！,雨色可可 第二季
绯弹的亚里亚 AA	緋弾のアリアAA	緋弾のアリアAA
动画锻炼！EX	あにトレ！EX	动画锻炼！EX,あにトレ！EX
女高中生给你做饭了！	JKめし！	JKめし！,女高中生给你做饭了！
我们这一家 新篇		新あたしンち
牙狼 -红莲之月-	牙狼 -紅蓮ノ月-	牙狼 红莲之月,牙狼 -紅蓮ノ月-,牙狼
双面骑士	シュヴァリエ 〜Le Chevalier D'Eon〜	女装骑士
I"s Pure		NULL
狗与剪刀的正确用法	犬とハサミは使いよう	犬とハサミは使いよう,狗与剪刀的正确使用方法,狗和剪刀要並用,狗与剪刀必有用
无家可归的小孩	家なき子レミ	
NINETEEN 19 1990		NULL
黑白小姐 第三季	ミス・モノクローム -The Animation- 3	ミス・モノクローム
网球并不可笑嘛 第六季	てーきゅう 6期	女高网球部 第六季,てーきゅう 6期,网球并不可笑嘛 第六季
K MISSING KINGS	K MISSING KINGS	K,K 剧场版,K MISSING KINGS
家有穆珂	いとしのムーコ	家有穆珂,LOVELY MUCO!,いとしのムーコ,可爱的穆珂
KOWABON	こわぼん	KOWABON,こわぼん
不可思议星球的双胞胎公主 第二季 		神秘星球孪生公主,不可思议星球的孪生公主,双子星公主
怪医黑杰克 OVA1		ブラック・ジャック,BLACK JACK
蝙蝠侠新冒险全二季		NULL
玉响～毕业写真～	たまゆら～卒業写真～	たまゆらじお,玉响,毕业照片,OVA
美国老爹		NULL
被狙击的学园	ねらわれた学園	
昆虫小精灵		NULL
凉宫春日的消失	涼宮ハルヒの消失	凉宫ハルヒの忧郁,すずみやハルヒのゆううつ
小魔女学园 魔法游行		LITTLEWITCHACADEMIA,リトル ウィッチ アカデミア
传颂之物 OVA	うたわれるもの OVA	うたわれるもの,受讚頌者,UTAWARERUMONO
一周的朋友。SP		一週間フレンズ。,一周的朋友,
魔兽战线		NULL
鬼神传		NULL
阳光中的青时雨		NULL
彗星公主	Cosmic Baton Girl コメットさん☆	彗星公主,音乐小彗星,コメットさん☆
赌博默示录  【国语】	逆境無頼カイジ Ultimate Survivor	赌博默示录,赌博破戒录,赌博堕天录,逆境无赖开司
逆境无赖开司 第二季【国语】		赌博默示录,赌博破戒录,赌博堕天录,逆境无赖开司
花田少年史	花田少年史	花田少年史,The History of Hanada Ic
妄想学生会＊ OVA	生徒会役員共＊ OVA	妄想学生会,黄段子学生会,SYD,生徒会役員共
暗黑之猫 Dark Cat		NULL
笨笨森林日志		NULL
开心汉堡店 第一季		NULL
开心汉堡店 第二季		NULL
开心汉堡店 第四季		NULL
开心汉堡店 第五季		NULL
鲁邦三世 次元大介的墓碑		ルパン三世,LUPIN THE THIRD,雷朋三世
滑头鬼之孙 第一季【国语】	ぬらりひょんの孫	滑头鬼
滑头鬼之孙 第二季【国语】	ぬらりひょんの孫～千年魔京～	滑头鬼,ぬらりひょんの孫～千年魔京～
恋爱☆迁都 COI☆SENTO		NULL
米老鼠的黑白动画片生涯		NULL
忍者神龟 第三季		TMNT
Fate/stay night [Unlimited Blade Works] 特典	Fate/stay night [Unlimited Blade Works] 特典映像「sunny day」	UBW,FSN/UBW,UNLIMITED BLADE WORKS,无限剑制
境界的彼方 -I'LL BE HERE- 未来篇	境界の彼方 -I'LL BE HERE- 未来篇	境界の彼方
女神异闻录3 剧场版 #1 Spring of Birth	PERSONA3 THE MOVIE #1 Spring of Birth	女神异闻录3,PERSONA3,女神异闻录3 剧场版, ペルソナ3
时间支配者		
影鳄	影鰐-KAGEWANI-	影鳄,KAGEWANI,影鰐-KAGEWANI-
浪漫追星社		宙のまにまに
浪漫追星社		宙のまにまに
翼·年代记 鸟笼国的公主	劇場版ツバサ・クロニクル 鳥カゴの国の姫君	ツバサ,TSUBASA翼,TSUBASA,翼年代记,鸟笼国的公主
翼·年代记 东京默示录	ツバサ TOKYO REVELATIONS	ツバサ,TSUBASA翼,TSUBASA,翼年代记
翼·年代记 春雷记	ツバサ 春雷記	ツバサ,TSUBASA翼,TSUBASA,翼年代记, 春雷记
邻座的怪同学		
无口的森田小姐 OVA		森田さんは无口
地球少女		NULL
魔法科高校的劣等生 简单易懂的魔法科！	よく わかる魔法科!	魔法科高校的劣等生,魔劣,简单易懂的魔法科
圣诞之吻 SP	アマガミSS	アマガミ,圣诞之吻SS,圣诞之吻SS＋PLUS,甜蜜吻痕
闪乱神乐	閃乱カグラ	闪乱神乐,閃亂神樂
Peeping Life		尿意人生
变形金刚大电影		NULL
猫眼三姐妹	キャッツ・アイ	猫眼三姐妹,キャッツアイ
七海小英雄		NULL
龙珠Z		NULL
奥祖玛		NULL
英雄传说 空之轨迹	英雄伝説 空の軌跡 THE ANIMATION	英雄传说,空之轨迹,空の軌跡
初音岛 T.P.樱	T.P.さくら	D.C,D.C.～ダ・カーポ～,T.P.樱,时间控制者
火球		FIREBALL
TO HEART 第二季		
TO HEART 第二季OVA		
少女与战车  SP	ガールズ&amp;パンツァー これが本当のアンツィオ戦です!	天才战车少女,天才坦克少女,ガールズ&パンツァー,GIRLS UND PANZER
紫式部 源氏物语	紫式部 源氏物語	源氏物语,紫式部 源氏物语,Genji Monogatari
RWBY 第三季	RWBY Volume 3	RWBY系列,Ruby Weiss Blake Yang
RWBY Volume2 1080P	RWBY Volume 2	RWBY系列,Ruby Weiss Blake Yang
小马宝莉 小马国女孩		彩虹小马,萌马,我的小马驹,彩虹小马：友谊是魔法,我的小马驹：友谊的魔力,小马宝莉：友谊的魔力,MLP,MY LITTLE PONY,FRIENDSHIP IS MAGIC,G4,MLP:FIM
学生会的一己之见 OVA		生徒会の一存,碧阳学园生徒会议事录,学生会的一存,碧阳学园学生会议事录
心之国爱丽丝 剧场版	劇場版 ハートの国のアリス～Wonderful Wonder World～	
四娘物语	よつのは	四娘物语よつのは,よつのは
CENCOROLL	センコロール	CENCOROLL,千子
星际迷航		NULL
帝都物语		NULL
TRUE TEARS	true tears	真实之泪,TRUE TEARS
交响诗篇 AO【国语】		交響詩篇エウレカセブン,エウレカセブンAO
狼雨	WOLF'S RAIN	狼雨,WOLF'S RAIN,ウルフズレイン
食梦者 【国语】	バクマン。	バクマン,BAKUMAN,食梦者
食梦者。2	バクマン。2	バクマン,BAKUMAN
食梦者。3【国语】	バクマン。3	バクマン,BAKUMAN
侦探歌剧 少女福尔摩斯 OVA	探偵オペラ ミルキィホームズ  OVA	探侦オペラ,　 ミルキィホームズ,侦探歌剧：少女福尔摩斯,侦探歌剧,MILKY HOLMES,探偵オペラ ミルキィホームズ
狼的孩子雨和雪	おおかみこどもの雨と雪	おおかみこどもの雨と雪,狼的孩子雨和雪
疯味英雄 		
花开伊吕波 Home Sweet Home	花咲くいろは HOME SWEET HOME	花开物语,花咲くいろは
打工吧！魔王大人	はたらく魔王さま!	はたらく魔王さま！,打工吧 魔王大人,はたらく魔王さま!
.HACK//Quantum		NULL
水晶国传说		NULL
飞轮少年 黑翼与沉睡森林 -Break on the sky-	エア·ギア 黒の羽と眠りの森	飞轮少年
宝贝公主	Baby Princess 3Dぱらだいす0	宝贝公主
潜行吧！奈亚子F	這いよれ! ニャル子さんF	這いよる! ニャルアニ！,潜行吧！奈亚子F
我的女神 第一季【国语】		我的女神,ああっ女神さまっ,幸运女神,幸運女神
日常工作 剧场版		REGULAR SHOW
妖魔	妖魔	
布雷斯塔警长		NULL
地狱一家客		NULL
魔女的考验		NULL
拽妹黛薇儿 第一季		NULL
拽妹黛薇儿 第二季		NULL
拽妹黛薇儿 第三季		NULL
拽妹黛薇儿 第四季		NULL
蜜桃女孩		NULL
ADVENTURE TIME 第七季		探险时间,探险活宝,探险时光
长歌行		
那年那兔那些事儿 第二季		那年那兔那些事儿
高地人：复仇之旅		NULL
应避忌之狼		NULL
浜虎SD（迷你浜虎）	ミニはま -MINIMUM HAMATORA-	浜虎,HAMATORA,ハマトラ,迷你浜虎,ミニはま
BLACK CAT	BLACK CAT	BLACK CAT,黑猫
格林童话剧场		NULL
佛兰德斯的狗		NULL
闯闯闯！我是闯堂兔！		SDFEA
特别的她	フリクリ	FLCL,特别的她,フリクリ,First Love Cyber Love
如果高中棒球社女经理读过杜拉克的《管理学》的话	もし高校野球の女子マネージャーがドラッカーの『マネジメント』を読んだら	如果杜拉,もしドラ,如果高中棒球社女经理读过杜拉克的管理学
恐怖！僵尸猫	きょーふ！ゾンビ猫	恐怖!ゾンビ猫,恐怖！僵尸猫
京四郎和永远的天空	京四郎と永遠の空	京四郎和永远的天空,京四郎と永遠の空
绯弹的亚里亚	緋弾のアリア	绯弹的亚莉亚,绯弾のアリア
君吻Pure Rouge	キミキス pure rouge	君吻Pure Rouge,キミキス pure rouge
海豚便利店		NULL
英国恋物语艾玛	英國戀物語エマ	英国恋物语艾玛,英國戀物語エマ
英国恋物语艾玛 第二幕	英國戀物語エマ 第二幕	英国恋物语艾玛 第二幕,エマ
消防员山姆		NULL
GA 艺术科美术设计班 OVA	GA 芸術科アートデザインクラス OVA	
星际牛仔 天国之扉	カウボーイビバップ 天国の扉	COWBOY BEBOP
希曼的新冒险		NULL
拽妹黛薇儿 剧场版		NULL
星空奇迹	星空キセキ	星空奇迹,星空キセキ
画江湖之 灵主		画江湖,灵主,画江湖之灵主
画江湖之 不良人		画江湖
银河铁道之夜	銀河鉄道の夜	银河铁道之夜,銀河鉄道の夜
从前有座灵剑山	霊剣山 星屑たちの宴	从前有座灵剑山
凹凸世界		NULL
贤治之春		NULL
莎拉公主	小公女セイラ	莎拉公主,小公主莎拉
FLAG		NULL
CROSSANGE 天使与龙的轮舞	クロスアンジュ 天使と竜の輪舞	クロスアンジュ
哥普拉		NULL
星星公主		骸なる星・珠たる子 なるたる,なるたる,星星少女
银河铁道之夜 2006		NULL
游☆戏☆王 Duel Monsters	遊☆戯☆王 デュエルモンスターズ	游戏王,YU-GI-OH!,遊戯王,游☆戏☆王,游戏王 DM,Duel Monsters,打牌王
土方岁三 白之轨迹		NULL
神枪少女 -IL TEATRINO- OVA	GUNSLINGER GIRL -IL TEATRINO OVA	神枪少女,枪姬,GUNSLINGER GIRL,ガンスリンガーガール
魔力女管家 第二季【FREEWIND】		まほろまてぃっく
Love Live!	ラブライブ!	明星学生妹,虚拟偶像组合,ラブライブ！,lovelive,ラブライブ! School idol project
早安恋味糕点店	Bonjour♪恋味パティスリー	BONJOUR恋味蛋糕店,BONJOUR♪恋味パティスリー,早安恋味蛋糕店
Love Live! 第二季	ラブライブ! 2期	SCHOOL IDOL PROJECT,ラブライブ！,lovelive
拂晓的尤娜	暁のヨナ	暁のヨナ
拖拉机司机		NULL
GJ部@	GJ部@	GJ部中等部
出云传奇		NULL
我的小行星		NULL
魔法少女莎琳娜		NULL
无敌超人赞波3		NULL
马男波杰克 第一季		Bojack Horseman,马男波杰克
马男波杰克2	Bojack Horseman Season 2	马男波杰克,Bojack Horseman Season2
阿莱蒂公主	アリーテ姫	阿莱蒂公主,アリーテ姫,Princess Arete
哥谭妹子 第一季		NULL
哥谭妹子 第二季		NULL
哥谭妹子 第三季		NULL
我要上太空		ふたつのスピカ,麦穗星之梦,两颗SPICA
梦幻之星online2	ファンタシースターオンライン2 ジ アニメーション	梦幻之星,梦幻之星online2,ファンタシースターオンライン2
石膏男孩	石膏ボーイズ	石膏男孩,石膏ボーイズ
无头骑士异闻录 x2 结	デュラララ!!×2 結	无头骑士异闻录,デュラララ,无头骑士异闻录 x2 结
魔法护士小麦R	ナースウィッチ小麦ちゃんＲ	魔法护士小麦R,ナースウィッチ小麦ちゃんＲ
亚人	亜人	亚人,亜人
苍之彼方的四重奏	蒼の彼方のフォーリズム	苍之彼方的四重奏,蒼の彼方のフォーリズム
赤发白雪姬 第二季	赤髪の白雪姫 第2クール	赤发白雪姬,赤髪の白雪姫,红发的白雪公主
红壳的潘多拉	紅殻のパンドラ	红壳的潘多拉,紅殻のパンドラ
黑之宣告	シュヴァルツェスマーケン	黑之宣告,シュヴァルツェスマーケン
房东妹子青春期！	大家さんは思春期！	房东妹子青春期,大家さんは思春期
少女们向荒野进发	少女たちは荒野を目指す	少女们向荒野进发,少女たちは荒野を目指す
粗点心战争	だがしかし	粗点心战争,だがしかし
魔法少女什么的已经够了啦。	魔法少女なんてもういいですから。	魔法少女什么的已经够了啦,魔法少女なんてもういいですから
舞武器舞乱伎	ブブキ·ブランキ	舞武器舞乱伎,ブブキ・ブランキ
简单易懂的现代魔法	よくわかる現代魔法	简单易懂的现代魔法,よくわかる現代魔法
天才宝贝		赤ちゃんと僕,宝贝和我
超地下偶像		NULL
最强机器人大王者		NULL
归宅部活动记录	帰宅部活動記録	帰宅部活動記録
恶搞之家 第一季		NULL
恶搞之家 第二季		NULL
恶搞之家 第三季		NULL
恶搞之家 第四季		NULL
恶搞之家 第五季		NULL
恶搞之家 第六季		NULL
恶搞之家 第七季		NULL
恶搞之家 第八季		NULL
恶搞之家 第九季		NULL
神不在的星期天	神さまのいない日曜日	神さまのいない日曜日,神不在的星期天
恶搞之家 第十季		NULL
仙乐传说		NULL
永井豪的Q版世界		NULL
蓝宝石之谜 剧场版		ふしぎの海のナディア,冒险少女娜汀亚,海底两万里,THE SECRET OF BLUE WATER,不可思议之海的娜汀亚
异邦人 无皇刃谭	ストレンヂア 無皇刃譚	异邦人 无皇刃谭,无皇刃谭,ストレンヂア 無皇刃譚
绿林寮	ここはグリーン・ウッド	绿林寮,ここはグリーン・ウッド
枪之国度	ガンフロンティア	枪之国度,ガンフロンティア
空中杀手	スカイ・クロラ The Sky Crawlers	空中杀手,The Sky Crawlers,スカイ・クロラ
见习神明 秘密的cocotama 	かみさまみならい ヒミツのここたま	见习神明 秘密的cocotama 
依巴拉度~时间篇	イバラード時間	
The Revelation	秘密 〜The Revelation〜	The Revelation,秘密 〜The Revelat
爱神巧克力		爱神巧克力ing
牙狼 -炎之刻印-	牙狼〈GARO〉-炎の刻印-	牙狼 炎之刻印,牙狼 -炎の刻印-,牙狼
大叔与棉花糖	おじさんとマシュマロ	大叔与棉花糖,おじさんとマシュマロ
地球变动之日	NULL	NULL
佩琳物语	NULL	小英的故事
时光诡域	NULL	NULL
日常工作 第七季	NULL	NULL
变形金刚2008	NULL	NULL
隐之王	隠の王	隠の王,隐之王
提亚拉之泪	ティアーズ・トゥ・ティアラ	提亚拉之泪,花冠之泪,ティアーズ・トゥ・ティアラ,TEARS TO TIARA
凉宫春日的消失【SOSG】	涼宮ハルヒの消失	涼宮ハルヒの消失
灵犬雪丽	NULL	NULL
搞姬日常	ひめゴト	搞姬日常,ひめゴト
RWBY 第一季【日语】	RWBY	RWBY,红白黑黄
变形金刚 三乘合体	NULL	变形金刚
圣哥传	NULL	NULL
火球	NULL	NULL
蛋黄酱萝莉	ぽてまよ	ぽてまよ,蛋黄酱萝莉
网球并不可笑嘛 第七季	てーきゅう 第7期	网球少女 ,网球并不可笑嘛 第七季,てーきゅう 第7期
SUSHI POLICE	SUSHI POLICE	SUSHI POLICE,寿司警察
矶部矶兵卫物语	磯部磯兵衛物語	矶部矶兵卫物语,磯部磯兵衛物語
英国一家 吃在正月	英国一家、正月を食べる	NULL
拉瓦拳星球	NULL	NULL
穿越宇宙的少女	宇宙をかける少女	宇宙をかける少女,穿越宇宙的少女
舞力四射	トライブクルクル	NULL
Little Busters!	リトルバスターズ！	リトルバスターズ！,Little Busters!
相聚一刻 TV版	NULL	NULL
江户盗贼团五叶	さらい屋 五葉	さらい屋五葉,江户盗贼团五叶
遗迹守护者	NULL	NULL
诡水疑云	NULL	NULL
黑白无双	NULL	NULL
十万个冷笑话 第三季	NULL	NULL
东京糖衣巧克力	東京マーブルチョコレート	东京糖衣巧克力,東京マーブルチョコレート
柴犬阿旺的和式生活	しばわんこの和のこころ	柴犬阿旺的和式生活,しばわんこの和のこころ
四畳半神话大系	四畳半神話大系	四叠半神话大系,四迭半神话大系
绝对少年	NULL	NULL
湾岸午夜	NULL	NULL
机械女神J	NULL	银河醒目女
机械女神J to X	NULL	NULL
机械女神J again	NULL	NULL
机械女神R	NULL	NULL
One Off	わんおふ -one off-	One Off
海岸物语	あじむ 〜海岸物語〜	海岸物语,あじむ 〜海岸物語〜
通职者		通职者
三年E班 第二季		三年E班,黄老师
青之六号	青の6号	青の6号,青之六号
他和她的故事	彼氏彼女の事情	彼氏彼女的故事,他和她的事情
兽械争霸	NULL	NULL
背骑少女	RIDEBACK	背骑少女,RIDEBACK
BROTHERS CONFLICT OVA	BROTHERS CONFLICT OVA	
银河英雄传说 剧场版	NULL	银英,銀河英雄伝説
潜艇代号707R	NULL	NULL
旅街LateShow	旅街レイトショー	旅街LateShow,旅街レイトショー
火影忍者 疾风传	NULL	NULL
晴空战士	NULL	
快要坏掉的八音盒	こわれかけのオルゴール	快要坏掉的八音盒,こわれかけのオルゴール
亚人 -冲动-	亜人 -衝動-	亚人,亜人
魔法学园MA	まかでみ・WAっしょい!	MAGICIAN'S ACADEMY,まじしゃんず あかでみい
奔波儿灞与灞波儿奔	NULL	NULL
Gate 奇幻异世界 炎龙篇		Gate 奇幻异世界, 炎龙篇
历物语	暦物語	历物语,暦物語
京骚戏画 WEB版	京騒戯画	京骚戏画
辛普森一家 第二十六季【双语】	NULL	THE SIMPSONS
绝对无敌雷神王	絶対無敵ライジンオー	绝对无敌雷神王
绝对无敌雷神王	絶対無敵ライジンオー	绝对无敌雷神王,絶対無敵ライジンオー
革命机Valvrave	革命機ヴァルヴレイヴ	革命机,VALVRAVE,革命機ヴァルヴレイヴ
我的裘可妹妹	ちょこッとSister	我的裘可妹妹,ちょこッとSister
湘南暴走族	湘南爆走族	
永恒传说	テイルズ オブ エターニア THE ANIMATION	永恒传说,テイルズ オブ エターニア
Z计划	プランゼット	NULL
蜂蜜与四叶草	ハチミツとクローバー	蜂蜜与四叶草,ハチミツとクローバー
蜂蜜与四叶草II	ハチミツとクローバー II	ハチミツとクローバー,蜂蜜与四叶草
SHUFFLE!	SHUFFLE!	SHUFFLE!
白想这么多	NULL	NULL
吃饭睡觉打豆豆 豆特么黑	NULL	NULL
吃饭睡觉打豆豆 神经豆	NULL	NULL
侠岚·决敌篇	NULL	NULL
侠岚·凌霜篇	NULL	NULL
银河英雄传说 TV版	銀河英雄伝説	莱茵哈特,银英,銀河英雄伝説
弃宝之岛 遥与魔法镜	ホッタラケの島 〜遥と魔法の鏡〜	
创龙传	創竜伝	
奏光之Strain	奏光のストレイン	奏光之Strain,奏光のストレイン
老虎和兔子	TIGER &  BUNNY	基友英雄传,老虎和兔子,TIGER＆BUNNY
西方善魔女	西の善き魔女 Astraea Testament	西方善魔女,西の善き魔女
夏娃的时间	イヴの時間	夏娃的时间,イヴの時間,Time of Eve
青之文学	青い文学シリーズ	青之文学,青い文学シリーズ
急救超人兵团	住めば都のコスモス荘  すっとこ大戦ドッコイダー	
虫之歌	ムシウタ	虫之歌,ムシウタ
佝偻猫 第一季	くるねこ	
佝偻猫 第二季	くるねこ Season2	
千岁 Get You!!	ちとせげっちゅ!!	千岁 Get You!!,ちとせげっちゅ!!
同人WORK	ドージンワーク	
泰坦尼亚	TYTANIA -タイタニア-	
辛普森一家 第二十七季	NULL	NULL
道子与哈金	ミチコとハッチン	道子与哈金,ミチコとハッチン,道子与花儿
龙之界点	ドラゴンクライシス!	龙之界点,ドラゴンクライシス!,Dragon Crisis!
这丑陋又美丽的世界	この醜くも美しい世界	这丑陋又美丽的世界,この醜くも美しい世界
怪谈餐厅	怪談レストラン	怪谈餐厅,怪谈餐馆,怪談レストラン
破刃之剑	ブレイク ブレイド	
境界的彼方	境界の彼方	境界的彼方,境彼,境界の彼方
境界的彼方 -I'LL BE HERE- 过去篇	境界の彼方 -I'LL BE HERE- 過去篇	境界的彼方 剧场版,境界的彼方 过去篇
段子狗日记		段子狗日记
南方公园 第七季		SOUTHPARK
爆蛋晶英	NULL	NULL
狱・再见绝望先生	獄・さよなら絶望先生	獄・さよなら絶望先生,狱・再见绝望先生
南方公园 第十一季	NULL	SOUTHPARK
短暂和平	SHORT PEACE	
魍魉之匣	魍魎の匣	魍魉之匣,魍魎の匣
她与她的猫	彼女と彼女の猫 -Everything Flows-	她与她的猫,她和她的猫
薄樱鬼 御伽草子	NULL	NULL
飞天小女警 第一季	NULL	NULL
飞天小女警 第二季	NULL	NULL
飞天小女警 第三季	NULL	NULL
飞天小女警 第四季	NULL	NULL
飞天小女警 第五季	NULL	NULL
飞天小女警 第六季	NULL	NULL
飞天小女警 特集 世界之钥	NULL	NULL
噬神者 SP	ゴッドイーター	噬神者,GE,GOD EATER ,ゴッドイーター
We Bare Bears 咱们裸熊 第二季	NULL	We Bare Bears
×××HOLiC·继		×××HOLiC,×××HOLiC 継
×××HOLiC·春梦记	×××HOLiC·春夢記	×××HOLiC,×××HOLiC 春梦记
×××HOLiC·笼	×××HOLiC・籠	×××HOLiC,×××HOLiC 笼
×××HOLiC·笼 徒梦	×××HOLiC・籠 あだゆめ	×××HOLiC,笼 徒梦
×××HOLiC 仲夏夜之梦	×××HOLiC 真夏ノ夜ノ夢	×××HOLiC,仲夏夜之梦
冰菓	氷菓	氷菓,冰菓,冰果,Hyouka
太乙仙魔录之灵飞纪	NULL	NULL
不思议游戏 OVA2 延续篇	ふしぎ遊戯 第二部	不可思议的游戏,梦幻游戏,魔幻游戏,ふしぎ遊戯
正义红师		正义红师
正义红师 粤语版		正义红师
樱花大战 OVA2 轰华绚烂	サクラ大戦 轟華絢爛	樱花大战,轰华绚烂,サクラ大戦 轟華絢爛
萌菌物语	もやしもん	萌菌物语,もやしもん
无敌看板娘	無敵看板娘	
樱花大战 OVA2.5 神崎堇引退纪念	サクラ大戦 神崎すみれ引退記念 す・み・れ	樱花大战,サクラ大戦,神崎堇引退纪念
樱花大战 OVA3 燃烧的巴黎	サクラ大戦 エコール・ド・巴里	樱花大战,サクラ大戦,樱花大战 燃烧的巴黎
樱花大战 OVA4 崭新的巴黎	サクラ大戦 ル・ヌーヴォー・巴里	樱花大战,サクラ大戦,樱花大战 崭新的巴黎
樱花大战 OVA5 纽约	サクラ大戦 ニューヨーク・紐育	樱花大战,サクラ大戦,樱花大战 纽约
樱花大战 剧场版 樱花大战活动写真	サクラ大戦 活動写真	樱花大战,サクラ大戦,樱花大战活动写真
废弃公主	スクラップド・プリンセス	
遥远时空中2 白龙之神子	遙かなる時空の中で2 〜白き龍の神子〜	遥远时空中,遙かなる時空の中で,遥远时空中 白龙之神子
遥远时空中3 红之月	遙かなる時空の中で3 紅の月	遥远时空中,遙かなる時空の中で,遥远时空中 红之月
干物妹！小埋 OVA 小埋、再一次！	干物妹!うまるちゃん OVA「うまるちゃん もう一回!」	干物妹小埋,小埋,干物妹!うまるちゃん
四月是你的谎言 OAD	四月は君の嘘 OAD	
我被绑架到贵族女校当庶民样本 SP		庶民标本,庶民样本,关于我被绑架到大小姐学校当庶民样本,俺がお嬢様学校に「庶民サンプル」としてゲッツされた件
OVERLORD SP	オーバーロード SP	オーバーロード,OVER LORD,不死者之王
异国迷宫的十字路口	異国迷路のクロワーゼ The Animation	异国迷宫的十字路口,異国迷路のクロワーゼ
兽之奏者艾琳	獣の奏者エリン	兽之奏者艾琳,獣の奏者エリン
吃谜少女	NULL	NULL
斩·赤红之瞳！ 爆笑小剧场		斩·赤红之瞳,アカメが斬る!
我的青春恋爱物语果然有问题 第一季 OVA	やはり俺の青春ラブコメはまちがっている。 OVA	Brain's Base,我的青春恋爱物语果然有问题,やはり俺の青春ラブコメはまちがっている
绯弹的亚里亚 第一季 OVA	緋弾のアリア	
鬼灯的冷彻	鬼灯の冷徹	鬼灯の冷徹,鬼灯,鬼灯的冷彻
黑子的篮球 第2期 OVA	黒子のバスケ 第2期 OVA	
黑子的篮球 第3期 OVA	黒子のバスケ 第3期 OVA	黒子のバスケ
夏目友人帐 OVA 曾几何时下雪之日	夏目友人帳 いつかゆきのひに,brain's base	夏目友人帐,夏目友人帳
夏目友人帐 OVA 和猫咪老师的第一次跑腿	夏目友人帳 ニャンコ先生とはじめてのおつかい	夏目友人帐,夏目友人帳,brain's base
赤发白雪姬 OVA 不值一提的宝物、这一页	赤髪の白雪姫 OVA なんでもない宝物、この頁	赤发白雪姬,赤髪の白雪姫,红发的白雪公主
命运石之门 聪明睿智的认知计算	Steins;Gate 聡明叡智のコグニティブ・コンピューティング	命运石之门,シュタインズ・ゲート,Steins Gate,石头门
命运石之门 境界面上的迷失之链	Steins;Gate 境界面上のミッシングリンク	命运石之门,シュタインズ・ゲート,Steins Gate,石头门
在下坂本，有何贵干？	坂本ですが？	NULL
迷家	迷家-マヨイガ-	NULL
三者三叶	三者三葉	NULL
鬼斩	鬼斬	NULL
甘城光辉游乐园 SP 激动人心小剧场	甘城ブリリアントパーク わくわくミニシアター	甘城光辉游乐园,甘城ブリリアントパーク,甘城BRILLIANT PARK
忍者杀手 SE	ニンジャスレイヤー (SE版)	NULL
兔龟 女高网球部外传	うさかめ	NULL
宇宙巡警露露子	宇宙パトロールルル子	NULL
面包带来和平！	パンでPeace！	NULL
Re：从零开始的异世界生活	Re:ゼロから始める異世界生活	NULL
双星之阴阳师	双星の陰陽師	NULL
百武装战记	ハンドレッド	NULL
学战都市Asterisk 第二季	学戦都市アスタリスク 2nd Season	学战都市Asterisk,学戦都市アスタリスク,学战都市 六芒星
Concrete Revolutio 超人幻想 第二季	NULL	NULL
魔笛MAGI 辛巴达的冒险	マギ シンドバッドの冒険	NULL
命运石之门 负荷领域的既视感	Steins;Gate 負荷領域のデジャヴ	命运石之门,シュタインズ・ゲート,Steins Gate,石头门
元气少女缘结神  过去篇	神様はじめました～過去編～	元气少女缘结神,神様はじめました
妄想学生会 OVA	生徒会役員共 OVA	妄想学生会,黄段子学生会,SYD,生徒会役員共
妄想学生会 OAD	生徒会役員共 OAD	
黑塔利亚 Axis Powers 第2期	ヘタリア Axis Powers 第2期	黑塔利亚,HETALIA,ヘタリア,APH
黑塔利亚 World Series 第4期	ヘタリア World Series 第4期	
魔法少女☆伊莉雅 OVA	Fate/kaleid liner プリズマ☆イリヤ ツヴァイ! OAD	Fate/kaleid liner,魔法少女伊莉雅,魔法少女伊利亚,fate,プリズマ☆イリヤ
魔法少女☆伊莉雅 2WEI! OVA	Fate/kaleid liner プリズマ☆イリヤ ツヴァイ! OAD	Fate/kaleid liner,魔法少女伊莉雅,魔法少女伊利亚,fate,プリズマ☆イリヤ
Crane Game Girls	美少女遊戯ユニット クレーンゲール	NULL
黑塔利亚 剧场版 银幕HETALIA Axis Powers Paint it, White	銀幕ヘタリア Axis Powers Paint it, White（白くぬれ!）	黑塔利亚,HETALIA,ヘタリア,APH,白塔利亚
我的朋友很少 OAD	僕は友達が少ない 第0語	我的朋友很少,僕は友達が少ない,邻人部
魔弹之王与战姬 SP 堤格尔君与战姬亲	魔弾の王と戦姫 ティグルくんとヴァナディーちゅ	魔弹之王与战姬,魔弾の王と戦姫
心灵侦探八云	心霊探偵 八雲	心灵侦探八云,心霊探偵 八雲
棺姬嘉依卡 OVA	棺姫のチャイカ OVA	
笨蛋，测验，召唤兽  OVA	バカとテストと召喚獣 〜祭〜	
加速世界 OVA1 银翼的觉醒	アクセル・ワールド -銀翼の覚醒-	
加速世界 OVA2 加速的顶点	アクセル・ワールド -加速の頂点-	
Infinite Stratos	NULL	Infinite Stratos,Infinite Stratos 2,无限斯特拉托斯
问题儿童都来自异世界？ OVA 温泉漫游记	問題児たちが異世界から来るそうですよ?〜温泉漫遊記〜	问题儿童都来自异世界,问题儿童
HELLO!! 黄金拼图	ハロー!!きんいろモザイク	HELLO!! 黄金拼图,黄金拼图
TARI TARI OVA	TARI TARI	
12岁。	NULL	NULL
甲铁城的卡巴内瑞	NULL	NULL
线上游戏的老婆不可能是女生？	NULL	NULL
机动战士敢达独角兽 RE:0096	NULL	敢达独角兽,机动战士敢达独角兽,MOBILE SUIT GUNDAM UNICORN,GUNDAM UC,機動戦士ガンダムUC
任性HighSpec	NULL	NULL
Anne-Happy	NULL	NULL
影鳄 承	影鰐-KAGEWANI-承	影鳄,KAGEWANI,影鰐 第二季,影鳄 承
小马宝莉 第六季	My Little Pony: Friendship Is Magic : S6	小马宝莉 第六季,My Little Pony: Frien
我们大家的河合庄 SP	僕らはみんな河合荘	我们大家的河合庄
勇者大冒险 第二季	NULL	NULL
快递侠外传	NULL	NULL
这样算是僵尸吗？ OVA	これはゾンビですか? OAD	这货是僵尸吗,这个是僵尸吗？ OF THE DEAD,これはゾンビですか? ,魔装少女就是本少爷
钢之炼金术师 FULLMETAL ALCHEMIST SP	鋼の錬金術師 FULLMETAL ALCHEMIST SP	钢之炼金术师,鋼の錬金術師,Fullmetal Alchemist,钢炼,钢炼FA
小桃小栗 Love Love物语	ももくり	NULL
逆转裁判	逆転裁判 その『真実』、異議あり！	
怪盗JOKER 第三季	怪盗ジョーカー シーズン3	怪盗ジョーカー,怪盗Joker
火星异种 REVENGE	テラフォーマーズ リベンジ	NULL
超时空要塞Δ	NULL	NULL
口水封神	NULL	NULL
美妙天堂  第三季	NULL	NULL
代号D机关	ジョーカー・ゲーム	JOKER GAME,鬼牌游戏
无头骑士异闻录×2 承 OVA	デュラララ!!×2 承 私の心は鍋模様	デュラララ!!×2 承 私の心は鍋模様
无头骑士异闻录 x2 转  OVA	デュラララ!!×2 転 お惚気チャカポコ	デュラララ!!×2 転 お惚気チャカポコ
番物语	NULL	NULL
青之驱魔师 剧场版	青の祓魔師 劇場版	青の祓魔師 劇場版,青之驱魔师 剧场版
青之驱魔师 小黑出走记	青の祓魔師 クロの家出	青之驱魔师 OVA,青の祓魔師 クロの家出
苍蓝钢铁的琶音 DC	劇場版 蒼き鋼のアルペジオ -アルス・ノヴァ- DC	劇場版 蒼き鋼のアルペジオ -アルス・ノヴァ- DC,苍蓝钢铁的琶音 DC
苍蓝钢铁的琶音 Cadenza	劇場版 蒼き鋼のアルペジオ -アルス・ノヴァ- Cadenza,苍蓝钢铁的琶音 Cadenza	劇場版 蒼き鋼のアルペジオ -アルス・ノヴァ- Cadenz
樱Trick	桜TRICK	樱Trick,桜TRICK
幸运星 OVA	らき☆すた OVA	らき☆すた,幸运星
猫猫日本史	NULL	NULL
飞天小女警 2016	NULL	NULL
黑色残骸	クロムクロ	NULL
幻想嘉年华 EX Season	カーニバル・ファンタズム EX Season	幻想嘉年华,カーニバル・ファンタズム,TAKE MOON,型月,幻想嘉年华 EX
幻想嘉年华 Special Season	カーニバル・ファンタズム Special Season	幻想嘉年华,カーニバル・ファンタズム,TAKE MOON,型月,幻想嘉年华SS
莉露莉露妖精莉露～妖精之门～	リルリルフェアリル～妖精のドア～	NULL
双月之城	NULL	NULL
魔卡少女樱	カードキャプターさくら	魔卡少女樱,百变小樱,初代萌王,百变小樱魔术卡
女神异闻录3 剧场版 #2 Midsummer Knight's Dream	PERSONA3 THE MOVIE #2 Midsummer Knight's Dream	女神异闻录3,PERSONA3,女神异闻录3 剧场版, ペルソナ3
女神异闻录3 剧场版 #3 Falling Down	PERSONA3 THE MOVIE #3 Falling Down	女神异闻录3,PERSONA3,女神异闻录3 剧场版, ペルソナ3
我的女神 OAD	ああっ女神さまっ OAD	我的女神,ああっ女神さまっ,幸运女神,幸運女神
今天开始做魔王 第一季	今日から㋮王!	今天开始做魔王,今日から㋮王!
今天开始做魔王 第三季	今日から㋮王! 第3章	今天开始做魔王 第三季,今日から㋮王! 第3章
文学少女 今日的点心～初恋～	“文学少女”今日のおやつ 〜はつ恋〜	文学少女 今日的点心～初恋～,“文学少女”今日のおやつ 〜は
Candy☆Boy OVA	Candy☆Boy	Candy☆Boy
百变之星 不死鸟传说 - 蕾拉・汉密尔顿物语	カレイドスター Legend of phoenix 〜レイラ・ハミルトン物語〜	百变之星 不死鸟传说,Legend of phoenix
百变之星 妙啊！妙！	カレイドスター ぐっどだよ! ぐぅーっど!	百变之星 Q版,百变之星  妙啊！妙！,
少女们向荒野进发 OVA	少女たちは荒野を目指す OVA	少女たちは荒野を目指す OVA,少女们向荒野进发 OVA
罪恶王冠 失落的圣诞节 an episode of port town	ギルティクラウン ロストクリスマス an episode of port town	罪恶王冠,ギルティクラウン,罪恶王冠 失落的圣诞节
青春之类 OAD	アオハライド OAD	青春之类OAD,アオハライド OAD
AIR 剧场版	Air 劇場版	AIR 剧场版,Air 劇場版
魔法禁书目录 炭	とある魔術の禁書目録たん	
DRAMAtical Murder OVA	DRAMAtical Murder	
绝园的暴风雨	绝园のテンペスト	绝园的暴风雨,绝园のテンペスト
偶像大师 灰姑娘女孩 第一季 OVA	アイドルマスター シンデレラガールズ	
偶像大师 灰姑娘女孩 第二季 OVA	アイドルマスター シンデレラガールズ 2ndシーズン	
天降之物 计时的悲伤女神	劇場版 そらのおとしもの 時計じかけの哀女神	天降之物 计时的悲伤女神, 发条装置之哀女神
零之使魔～三美姬的轮舞～OVA	ゼロの使い魔 ～三美姫の輪舞～OVA	零之使魔三美姬的轮舞,三美姬的轮舞OVA,
寒蝉鸣泣之时 扩	ひぐらしのなく頃に拡〜アウトブレイク〜	寒蝉鸣泣之时 扩
